GEOID,NAME,year,total_units,owner_occupied,renter_occupied,owner_occupancy_rate,renter_occupancy_rate,rent_burdened,total_renters,percent_rent_burdened
18097320800,"Census Tract 3208, Marion County, Indiana",2015,1195,1119,76,93.64016736401673,6.359832635983263,9,76,11.842105263157896
18097321200,"Census Tract 3212, Marion County, Indiana",2015,2201,1734,467,78.78237164925034,21.21762835074966,69,467,14.775160599571734
18097330401,"Census Tract 3304.01, Marion County, Indiana",2015,2172,1573,599,72.42173112338858,27.578268876611418,316,599,52.75459098497496
18097330900,"Census Tract 3309, Marion County, Indiana",2015,1885,652,1233,34.58885941644562,65.41114058355437,736,1233,59.69180859691809
18097340101,"Census Tract 3401.01, Marion County, Indiana",2015,1370,1132,238,82.62773722627738,17.37226277372263,105,238,44.11764705882353
18097340600,"Census Tract 3406, Marion County, Indiana",2015,1814,928,886,51.15766262403528,48.84233737596472,627,886,70.76749435665914
18097341100,"Census Tract 3411, Marion County, Indiana",2015,840,441,399,52.5,47.5,252,399,63.1578947368421
18097342000,"Census Tract 3420, Marion County, Indiana",2015,2184,1923,261,88.04945054945055,11.95054945054945,211,261,80.84291187739464
18097350800,"Census Tract 3508, Marion County, Indiana",2015,944,237,707,25.10593220338983,74.89406779661017,392,707,55.445544554455445
18097351200,"Census Tract 3512, Marion County, Indiana",2015,824,321,503,38.95631067961165,61.04368932038835,350,503,69.58250497017893
18097352100,"Census Tract 3521, Marion County, Indiana",2015,756,353,403,46.6931216931217,53.3068783068783,315,403,78.1637717121588
18097356200,"Census Tract 3562, Marion County, Indiana",2015,830,320,510,38.55421686746988,61.44578313253012,227,510,44.509803921568626
18097357900,"Census Tract 3579, Marion County, Indiana",2015,1644,992,652,60.34063260340633,39.65936739659367,382,652,58.58895705521472
18097360101,"Census Tract 3601.01, Marion County, Indiana",2015,873,284,589,32.531500572737684,67.46849942726232,353,589,59.9320882852292
18097360402,"Census Tract 3604.02, Marion County, Indiana",2015,615,308,307,50.08130081300813,49.91869918699187,183,307,59.60912052117264
18097360700,"Census Tract 3607, Marion County, Indiana",2015,774,627,147,81.0077519379845,18.992248062015506,63,147,42.857142857142854
18097360900,"Census Tract 3609, Marion County, Indiana",2015,2232,1317,915,59.005376344086024,40.994623655913976,597,915,65.24590163934427
18097361000,"Census Tract 3610, Marion County, Indiana",2015,848,715,133,84.31603773584905,15.683962264150944,39,133,29.32330827067669
18097310201,"Census Tract 3102.01, Marion County, Indiana",2015,1373,889,484,64.74872541879097,35.25127458120903,345,484,71.28099173553719
18097352400,"Census Tract 3524, Marion County, Indiana",2015,1338,624,714,46.63677130044843,53.36322869955157,518,714,72.54901960784314
18097352700,"Census Tract 3527, Marion County, Indiana",2015,1049,353,696,33.6510962821735,66.3489037178265,287,696,41.235632183908045
18097330700,"Census Tract 3307, Marion County, Indiana",2015,2475,1814,661,73.29292929292929,26.707070707070706,149,661,22.54160363086233
18097350100,"Census Tract 3501, Marion County, Indiana",2015,618,310,308,50.16181229773463,49.83818770226537,182,308,59.09090909090909
18097340400,"Census Tract 3404, Marion County, Indiana",2015,1204,542,662,45.016611295681066,54.983388704318934,407,662,61.48036253776435
18097342400,"Census Tract 3424, Marion County, Indiana",2015,634,266,368,41.95583596214511,58.04416403785489,196,368,53.26086956521739
18097342500,"Census Tract 3425, Marion County, Indiana",2015,1688,1128,560,66.82464454976304,33.175355450236964,365,560,65.17857142857143
18097350500,"Census Tract 3505, Marion County, Indiana",2015,887,397,490,44.7576099210823,55.2423900789177,207,490,42.244897959183675
18097350600,"Census Tract 3506, Marion County, Indiana",2015,1808,1082,726,59.84513274336283,40.15486725663717,485,726,66.80440771349862
18097351600,"Census Tract 3516, Marion County, Indiana",2015,928,411,517,44.28879310344828,55.71120689655172,241,517,46.61508704061895
18097352500,"Census Tract 3525, Marion County, Indiana",2015,1349,807,542,59.822090437361005,40.177909562638995,371,542,68.45018450184502
18097352800,"Census Tract 3528, Marion County, Indiana",2015,414,142,272,34.29951690821256,65.70048309178743,174,272,63.970588235294116
18097353600,"Census Tract 3536, Marion County, Indiana",2015,859,389,470,45.28521536670547,54.71478463329453,281,470,59.787234042553195
18097354900,"Census Tract 3549, Marion County, Indiana",2015,988,399,589,40.38461538461539,59.61538461538461,356,589,60.44142614601019
18097355900,"Census Tract 3559, Marion County, Indiana",2015,867,427,440,49.25028835063437,50.74971164936563,252,440,57.27272727272727
18097357000,"Census Tract 3570, Marion County, Indiana",2015,894,377,517,42.17002237136465,57.82997762863535,414,517,80.07736943907156
18097360102,"Census Tract 3601.02, Marion County, Indiana",2015,1016,447,569,43.996062992125985,56.003937007874015,302,569,53.07557117750439
18097380700,"Census Tract 3807, Marion County, Indiana",2015,2238,977,1261,43.655049151027704,56.344950848972296,772,1261,61.221252973830296
18097361400,"Census Tract 3614, Marion County, Indiana",2015,3971,2780,1191,70.0075547720977,29.99244522790229,451,1191,37.86733837111671
18097361600,"Census Tract 3616, Marion County, Indiana",2015,2845,2740,105,96.30931458699473,3.6906854130052724,65,105,61.904761904761905
18097380300,"Census Tract 3803, Marion County, Indiana",2015,1814,760,1054,41.89636163175303,58.10363836824697,456,1054,43.26375711574953
18097381001,"Census Tract 3810.01, Marion County, Indiana",2015,2924,935,1989,31.976744186046513,68.02325581395348,810,1989,40.723981900452486
18097380100,"Census Tract 3801, Marion County, Indiana",2015,6618,4946,1672,74.7355696585071,25.264430341492897,551,1672,32.95454545454545
18097381201,"Census Tract 3812.01, Marion County, Indiana",2015,2985,2047,938,68.57621440536013,31.423785594639867,456,938,48.61407249466951
18097381205,"Census Tract 3812.05, Marion County, Indiana",2015,2564,1057,1507,41.22464898595944,58.77535101404056,895,1507,59.389515593895155
18097321400,"Census Tract 3214, Marion County, Indiana",2015,2490,1663,827,66.78714859437751,33.21285140562249,254,827,30.71342200725514
18097322300,"Census Tract 3223, Marion County, Indiana",2015,1128,771,357,68.35106382978724,31.648936170212767,82,357,22.969187675070028
18097330105,"Census Tract 3301.05, Marion County, Indiana",2015,2479,814,1665,32.83582089552239,67.16417910447761,586,1665,35.1951951951952
18097340108,"Census Tract 3401.08, Marion County, Indiana",2015,848,167,681,19.693396226415093,80.30660377358491,469,681,68.86930983847283
18097350400,"Census Tract 3504, Marion County, Indiana",2015,1035,494,541,47.729468599033815,52.270531400966185,377,541,69.68576709796673
18097350700,"Census Tract 3507, Marion County, Indiana",2015,599,375,224,62.60434056761269,37.39565943238731,155,224,69.19642857142857
18097350900,"Census Tract 3509, Marion County, Indiana",2015,521,231,290,44.33781190019194,55.66218809980806,142,290,48.96551724137931
18097351700,"Census Tract 3517, Marion County, Indiana",2015,1008,483,525,47.916666666666664,52.083333333333336,334,525,63.61904761904762
18097361100,"Census Tract 3611, Marion County, Indiana",2015,1421,771,650,54.25756509500352,45.74243490499648,311,650,47.84615384615385
18097370201,"Census Tract 3702.01, Marion County, Indiana",2015,1502,638,864,42.47669773635153,57.52330226364847,343,864,39.699074074074076
18097381002,"Census Tract 3810.02, Marion County, Indiana",2015,1169,1021,148,87.33960650128314,12.660393498716852,62,148,41.891891891891895
18097390200,"Census Tract 3902, Marion County, Indiana",2015,1200,1005,195,83.75,16.25,113,195,57.94871794871795
18097390403,"Census Tract 3904.03, Marion County, Indiana",2015,3333,3173,160,95.1995199519952,4.8004800480048,38,160,23.75
18097310103,"Census Tract 3101.03, Marion County, Indiana",2015,2434,2131,303,87.55135579293345,12.448644207066557,96,303,31.683168316831683
18097310105,"Census Tract 3101.05, Marion County, Indiana",2015,1608,919,689,57.15174129353234,42.84825870646766,243,689,35.268505079825836
18097310108,"Census Tract 3101.08, Marion County, Indiana",2015,1461,1200,261,82.13552361396304,17.864476386036962,75,261,28.735632183908045
18097320203,"Census Tract 3202.03, Marion County, Indiana",2015,1751,328,1423,18.732153055396918,81.26784694460308,643,1423,45.18622628250176
18097320500,"Census Tract 3205, Marion County, Indiana",2015,1407,713,694,50.675195451314856,49.324804548685144,292,694,42.07492795389049
18097320901,"Census Tract 3209.01, Marion County, Indiana",2015,2586,1796,790,69.4508894044857,30.549110595514307,404,790,51.139240506329116
18097360301,"Census Tract 3603.01, Marion County, Indiana",2015,1248,597,651,47.83653846153846,52.16346153846154,264,651,40.55299539170507
18097360401,"Census Tract 3604.01, Marion County, Indiana",2015,2149,553,1596,25.732899022801302,74.2671009771987,813,1596,50.93984962406015
18097380501,"Census Tract 3805.01, Marion County, Indiana",2015,1003,670,333,66.79960119641076,33.20039880358923,179,333,53.753753753753756
18097390402,"Census Tract 3904.02, Marion County, Indiana",2015,4319,3518,801,81.4540402871035,18.545959712896504,273,801,34.08239700374532
18097321300,"Census Tract 3213, Marion County, Indiana",2015,1160,665,495,57.327586206896555,42.672413793103445,173,495,34.94949494949495
18097330103,"Census Tract 3301.03, Marion County, Indiana",2015,2636,1622,1014,61.53262518968133,38.46737481031867,335,1014,33.03747534516765
18097330600,"Census Tract 3306, Marion County, Indiana",2015,1942,977,965,50.30895983522142,49.69104016477858,497,965,51.50259067357513
18097322600,"Census Tract 3226, Marion County, Indiana",2015,1874,365,1509,19.477054429028815,80.52294557097119,900,1509,59.642147117296226
18097321100,"Census Tract 3211, Marion County, Indiana",2015,1552,1093,459,70.42525773195877,29.574742268041238,158,459,34.42265795206972
18097320400,"Census Tract 3204, Marion County, Indiana",2015,1398,649,749,46.42346208869814,53.57653791130186,359,749,47.930574098798395
18097321002,"Census Tract 3210.02, Marion County, Indiana",2015,1829,1258,571,68.78075451066157,31.219245489338437,264,571,46.234676007005255
18097380600,"Census Tract 3806, Marion County, Indiana",2015,2199,962,1237,43.747157798999545,56.252842201000455,783,1237,63.29830234438157
18097321800,"Census Tract 3218, Marion County, Indiana",2015,1585,1085,500,68.45425867507886,31.545741324921135,112,500,22.4
18097322200,"Census Tract 3222, Marion County, Indiana",2015,745,500,245,67.11409395973155,32.88590604026846,118,245,48.16326530612245
18097330203,"Census Tract 3302.03, Marion County, Indiana",2015,2078,1964,114,94.51395572666026,5.48604427333975,19,114,16.666666666666668
18097341902,"Census Tract 3419.02, Marion County, Indiana",2015,1460,1240,220,84.93150684931507,15.068493150684931,95,220,43.18181818181818
18097330204,"Census Tract 3302.04, Marion County, Indiana",2015,2084,1639,445,78.6468330134357,21.3531669865643,81,445,18.202247191011235
18097330500,"Census Tract 3305, Marion County, Indiana",2015,2444,1437,1007,58.797054009819966,41.202945990180034,629,1007,62.46276067527309
18097352300,"Census Tract 3523, Marion County, Indiana",2015,540,249,291,46.111111111111114,53.888888888888886,164,291,56.3573883161512
18097355100,"Census Tract 3551, Marion County, Indiana",2015,733,257,476,35.06139154160982,64.93860845839018,293,476,61.554621848739494
18097355300,"Census Tract 3553, Marion County, Indiana",2015,1024,486,538,47.4609375,52.5390625,321,538,59.66542750929368
18097360602,"Census Tract 3606.02, Marion County, Indiana",2015,2540,1303,1237,51.2992125984252,48.7007874015748,737,1237,59.57962813257882
18097340800,"Census Tract 3408, Marion County, Indiana",2015,755,515,240,68.21192052980132,31.788079470198674,107,240,44.583333333333336
18097351500,"Census Tract 3515, Marion County, Indiana",2015,809,206,603,25.46353522867738,74.53646477132263,309,603,51.243781094527364
18097320903,"Census Tract 3209.03, Marion County, Indiana",2015,1719,503,1216,29.261198371146016,70.73880162885399,629,1216,51.72697368421053
18097360601,"Census Tract 3606.01, Marion County, Indiana",2015,1905,1428,477,74.96062992125984,25.03937007874016,172,477,36.058700209643604
18097320106,"Census Tract 3201.06, Marion County, Indiana",2015,1012,569,443,56.22529644268775,43.77470355731225,202,443,45.598194130925506
18097322500,"Census Tract 3225, Marion County, Indiana",2015,687,163,524,23.726346433770015,76.27365356622998,266,524,50.76335877862596
18097342200,"Census Tract 3422, Marion County, Indiana",2015,1984,962,1022,48.48790322580645,51.51209677419355,439,1022,42.95499021526419
18097355600,"Census Tract 3556, Marion County, Indiana",2015,676,379,297,56.06508875739645,43.93491124260355,221,297,74.41077441077441
18097310305,"Census Tract 3103.05, Marion County, Indiana",2015,2421,956,1465,39.487814952498965,60.512185047501035,721,1465,49.215017064846414
18097322100,"Census Tract 3221, Marion County, Indiana",2015,1083,660,423,60.94182825484764,39.05817174515236,214,423,50.59101654846336
18097342300,"Census Tract 3423, Marion County, Indiana",2015,2530,1255,1275,49.60474308300395,50.39525691699605,738,1275,57.88235294117647
18097353300,"Census Tract 3533, Marion County, Indiana",2015,1682,177,1505,10.523186682520809,89.4768133174792,613,1505,40.730897009966775
18097357100,"Census Tract 3571, Marion County, Indiana",2015,920,310,610,33.69565217391305,66.30434782608695,428,610,70.1639344262295
18097352600,"Census Tract 3526, Marion County, Indiana",2015,1217,550,667,45.19309778142974,54.80690221857026,370,667,55.472263868065966
18097353500,"Census Tract 3535, Marion County, Indiana",2015,1067,167,900,15.651358950328023,84.34864104967198,420,900,46.666666666666664
18097354800,"Census Tract 3548, Marion County, Indiana",2015,622,176,446,28.29581993569132,71.70418006430869,278,446,62.33183856502242
18097355000,"Census Tract 3550, Marion County, Indiana",2015,739,261,478,35.317997293640055,64.68200270635995,277,478,57.94979079497908
18097357500,"Census Tract 3575, Marion County, Indiana",2015,1579,1143,436,72.38758708043065,27.612412919569348,219,436,50.22935779816514
18097357600,"Census Tract 3576, Marion County, Indiana",2015,2568,1304,1264,50.77881619937695,49.22118380062305,907,1264,71.75632911392405
18097360202,"Census Tract 3602.02, Marion County, Indiana",2015,1082,805,277,74.39926062846581,25.600739371534196,191,277,68.95306859205776
18097310306,"Census Tract 3103.06, Marion County, Indiana",2015,2167,565,1602,26.07291185971389,73.92708814028612,866,1602,54.05742821473159
18097320304,"Census Tract 3203.04, Marion County, Indiana",2015,2784,1793,991,64.40373563218391,35.59626436781609,416,991,41.97780020181635
18097321001,"Census Tract 3210.01, Marion County, Indiana",2015,1020,803,217,78.72549019607843,21.274509803921568,71,217,32.71889400921659
18097356400,"Census Tract 3564, Marion County, Indiana",2015,1491,649,842,43.52783366867874,56.47216633132126,444,842,52.73159144893112
18097354400,"Census Tract 3544, Marion County, Indiana",2015,686,343,343,50,50,179,343,52.1865889212828
18097331000,"Census Tract 3310, Marion County, Indiana",2015,1652,1026,626,62.106537530266344,37.893462469733656,360,626,57.50798722044728
18097340500,"Census Tract 3405, Marion County, Indiana",2015,1706,485,1221,28.429073856975382,71.57092614302462,640,1221,52.416052416052416
18097340700,"Census Tract 3407, Marion County, Indiana",2015,1324,637,687,48.11178247734139,51.88821752265861,347,687,50.509461426491995
18097341700,"Census Tract 3417, Marion County, Indiana",2015,1720,958,762,55.69767441860465,44.30232558139535,567,762,74.40944881889764
18097350300,"Census Tract 3503, Marion County, Indiana",2015,1269,162,1107,12.76595744680851,87.23404255319149,681,1107,61.517615176151764
18097351900,"Census Tract 3519, Marion County, Indiana",2015,1044,552,492,52.87356321839081,47.12643678160919,286,492,58.13008130081301
18097355400,"Census Tract 3554, Marion County, Indiana",2015,1349,381,968,28.243143068939954,71.75685693106004,577,968,59.607438016528924
18097355500,"Census Tract 3555, Marion County, Indiana",2015,1392,799,593,57.39942528735632,42.60057471264368,269,593,45.36256323777403
18097356900,"Census Tract 3569, Marion County, Indiana",2015,1024,449,575,43.84765625,56.15234375,296,575,51.47826086956522
18097357200,"Census Tract 3572, Marion County, Indiana",2015,910,426,484,46.81318681318681,53.18681318681319,378,484,78.09917355371901
18097358000,"Census Tract 3580, Marion County, Indiana",2015,490,287,203,58.57142857142857,41.42857142857143,72,203,35.467980295566505
18097370202,"Census Tract 3702.02, Marion County, Indiana",2015,2453,1255,1198,51.16184264166327,48.83815735833673,809,1198,67.52921535893155
18097360302,"Census Tract 3603.02, Marion County, Indiana",2015,831,253,578,30.445246690734056,69.55475330926595,339,578,58.65051903114187
18097361200,"Census Tract 3612, Marion County, Indiana",2015,1351,728,623,53.8860103626943,46.1139896373057,360,623,57.78491171749599
18097361300,"Census Tract 3613, Marion County, Indiana",2015,937,746,191,79.61579509071505,20.384204909284954,79,191,41.361256544502616
18097380402,"Census Tract 3804.02, Marion County, Indiana",2015,1746,429,1317,24.57044673539519,75.4295532646048,649,1317,49.278663629460894
18097360201,"Census Tract 3602.01, Marion County, Indiana",2015,1574,626,948,39.7712833545108,60.2287166454892,436,948,45.9915611814346
18097322400,"Census Tract 3224, Marion County, Indiana",2015,1353,617,736,45.602365114560236,54.397634885439764,249,736,33.83152173913044
18097330106,"Census Tract 3301.06, Marion County, Indiana",2015,2482,472,2010,19.016921837228043,80.98307816277196,971,2010,48.308457711442784
18097330107,"Census Tract 3301.07, Marion County, Indiana",2015,2479,2356,123,95.03832190399355,4.961678096006454,61,123,49.59349593495935
18097320105,"Census Tract 3201.05, Marion County, Indiana",2015,1877,1034,843,55.08790623335109,44.91209376664891,353,843,41.87425860023725
18097320204,"Census Tract 3202.04, Marion County, Indiana",2015,2566,453,2113,17.653936087295403,82.3460639127046,1076,2113,50.92285849503076
18097320600,"Census Tract 3206, Marion County, Indiana",2015,1132,814,318,71.90812720848056,28.091872791519435,184,318,57.861635220125784
18097321700,"Census Tract 3217, Marion County, Indiana",2015,2025,1288,737,63.60493827160494,36.39506172839506,232,737,31.478968792401627
18097330202,"Census Tract 3302.02, Marion County, Indiana",2015,3759,2247,1512,59.77653631284916,40.22346368715084,940,1512,62.16931216931217
18097340111,"Census Tract 3401.11, Marion County, Indiana",2015,1043,815,228,78.13998082454458,21.860019175455417,55,228,24.12280701754386
18097340112,"Census Tract 3401.12, Marion County, Indiana",2015,2450,1016,1434,41.46938775510204,58.53061224489796,684,1434,47.69874476987448
18097340113,"Census Tract 3401.13, Marion County, Indiana",2015,1532,1086,446,70.88772845953002,29.112271540469973,372,446,83.40807174887892
18097340114,"Census Tract 3401.14, Marion County, Indiana",2015,1537,1325,212,86.20689655172414,13.793103448275861,73,212,34.43396226415094
18097340201,"Census Tract 3402.01, Marion County, Indiana",2015,1128,729,399,64.62765957446808,35.37234042553192,161,399,40.35087719298246
18097340202,"Census Tract 3402.02, Marion County, Indiana",2015,1849,598,1251,32.341806381828015,67.65819361817198,703,1251,56.19504396482814
18097340902,"Census Tract 3409.02, Marion County, Indiana",2015,3019,582,2437,19.277906591586618,80.72209340841339,1270,2437,52.11325400082068
18097341904,"Census Tract 3419.04, Marion County, Indiana",2015,916,255,661,27.83842794759825,72.16157205240175,341,661,51.58850226928896
18097370301,"Census Tract 3703.01, Marion County, Indiana",2015,2976,2555,421,85.85349462365592,14.146505376344086,183,421,43.46793349168646
18097340901,"Census Tract 3409.01, Marion County, Indiana",2015,1440,1291,149,89.65277777777777,10.347222222222221,26,149,17.449664429530202
18097341903,"Census Tract 3419.03, Marion County, Indiana",2015,2288,363,1925,15.865384615384615,84.13461538461539,1079,1925,56.05194805194805
18097370302,"Census Tract 3703.02, Marion County, Indiana",2015,2990,2456,534,82.14046822742475,17.859531772575252,252,534,47.19101123595506
18097380403,"Census Tract 3804.03, Marion County, Indiana",2015,1437,874,563,60.82115518441197,39.17884481558803,246,563,43.69449378330373
18097360501,"Census Tract 3605.01, Marion County, Indiana",2015,2327,1412,915,60.678985818650624,39.321014181349376,445,915,48.63387978142077
18097320303,"Census Tract 3203.03, Marion County, Indiana",2015,1795,0,1795,0,100,524,1795,29.192200557103064
18097320902,"Census Tract 3209.02, Marion County, Indiana",2015,1656,516,1140,31.159420289855074,68.84057971014492,685,1140,60.08771929824562
18097321600,"Census Tract 3216, Marion County, Indiana",2015,2191,1035,1156,47.238703788224555,52.761296211775445,640,1156,55.36332179930796
18097380404,"Census Tract 3804.04, Marion County, Indiana",2015,1613,1097,516,68.00991940483571,31.99008059516429,276,516,53.48837209302326
18097390101,"Census Tract 3901.01, Marion County, Indiana",2015,2880,2456,424,85.27777777777777,14.722222222222221,200,424,47.16981132075472
18097390102,"Census Tract 3901.02, Marion County, Indiana",2015,1998,823,1175,41.191191191191194,58.808808808808806,580,1175,49.361702127659576
18097390404,"Census Tract 3904.04, Marion County, Indiana",2015,2054,1518,536,73.904576436222,26.095423563777995,196,536,36.56716417910448
18097390405,"Census Tract 3904.05, Marion County, Indiana",2015,1786,536,1250,30.011198208286675,69.98880179171333,356,1250,28.48
18097390500,"Census Tract 3905, Marion County, Indiana",2015,932,465,467,49.892703862660944,50.107296137339056,248,467,53.104925053533194
18097390600,"Census Tract 3906, Marion County, Indiana",2015,2395,472,1923,19.707724425887264,80.29227557411274,894,1923,46.48985959438377
18097390700,"Census Tract 3907, Marion County, Indiana",2015,972,413,559,42.489711934156375,57.510288065843625,385,559,68.87298747763865
18097390800,"Census Tract 3908, Marion County, Indiana",2015,1301,817,484,62.7978478093774,37.2021521906226,158,484,32.64462809917355
18097390900,"Census Tract 3909, Marion County, Indiana",2015,1215,399,816,32.839506172839506,67.1604938271605,323,816,39.583333333333336
18097391000,"Census Tract 3910, Marion County, Indiana",2015,2625,323,2302,12.304761904761905,87.6952380952381,1037,2302,45.04778453518679
18097321900,"Census Tract 3219, Marion County, Indiana",2015,1215,895,320,73.66255144032922,26.337448559670783,130,320,40.625
18097322000,"Census Tract 3220, Marion County, Indiana",2015,1590,722,868,45.40880503144654,54.59119496855346,360,868,41.474654377880185
18097322700,"Census Tract 3227, Marion County, Indiana",2015,924,601,323,65.04329004329004,34.95670995670996,209,323,64.70588235294117
18097340102,"Census Tract 3401.02, Marion County, Indiana",2015,1661,283,1378,17.03792895845876,82.96207104154124,879,1378,63.78809869375907
18097341000,"Census Tract 3410, Marion County, Indiana",2015,817,660,157,80.78335373317013,19.216646266829866,34,157,21.656050955414013
18097351000,"Census Tract 3510, Marion County, Indiana",2015,1075,309,766,28.74418604651163,71.25581395348837,461,766,60.18276762402089
18097340300,"Census Tract 3403, Marion County, Indiana",2015,2510,924,1586,36.81274900398407,63.18725099601593,939,1586,59.20554854981084
18097341200,"Census Tract 3412, Marion County, Indiana",2015,774,359,415,46.382428940568474,53.617571059431526,223,415,53.734939759036145
18097341600,"Census Tract 3416, Marion County, Indiana",2015,768,286,482,37.239583333333336,62.760416666666664,217,482,45.02074688796681
18097342101,"Census Tract 3421.01, Marion County, Indiana",2015,1822,1391,431,76.34467618002195,23.655323819978047,207,431,48.02784222737819
18097310110,"Census Tract 3101.10, Marion County, Indiana",2015,1348,675,673,50.074183976261125,49.925816023738875,257,673,38.187221396731054
18097310111,"Census Tract 3101.11, Marion County, Indiana",2015,1587,641,946,40.39067422810334,59.60932577189666,402,946,42.494714587737846
18097310204,"Census Tract 3102.04, Marion County, Indiana",2015,1853,1109,744,59.84889368591473,40.15110631408527,444,744,59.67741935483871
18097310310,"Census Tract 3103.10, Marion County, Indiana",2015,1616,1197,419,74.07178217821782,25.928217821782177,181,419,43.198090692124104
18097310203,"Census Tract 3102.03, Marion County, Indiana",2015,2355,1255,1100,53.29087048832272,46.70912951167728,603,1100,54.81818181818182
18097310309,"Census Tract 3103.09, Marion County, Indiana",2015,1559,302,1257,19.371391917896087,80.62860808210391,597,1257,47.49403341288783
18097310311,"Census Tract 3103.11, Marion County, Indiana",2015,1763,1668,95,94.6114577424844,5.388542257515598,52,95,54.73684210526316
18097310312,"Census Tract 3103.12, Marion County, Indiana",2015,2424,849,1575,35.024752475247524,64.97524752475248,848,1575,53.84126984126984
18097330108,"Census Tract 3301.08, Marion County, Indiana",2015,1439,1420,19,98.67963863794301,1.320361362056984,0,19,0
18097330109,"Census Tract 3301.09, Marion County, Indiana",2015,2140,2007,133,93.78504672897196,6.214953271028038,14,133,10.526315789473685
18097330206,"Census Tract 3302.06, Marion County, Indiana",2015,1697,1551,146,91.39658220388921,8.603417796110783,0,146,0
18097330209,"Census Tract 3302.09, Marion County, Indiana",2015,3216,2770,446,86.1318407960199,13.868159203980099,175,446,39.237668161434975
18097330208,"Census Tract 3302.08, Marion County, Indiana",2015,1196,956,240,79.93311036789298,20.066889632107024,135,240,56.25
18097330803,"Census Tract 3308.03, Marion County, Indiana",2015,1394,331,1063,23.74461979913917,76.25538020086083,676,1063,63.59360301034807
18097330804,"Census Tract 3308.04, Marion County, Indiana",2015,1160,198,962,17.06896551724138,82.93103448275862,475,962,49.37629937629938
18097354700,"Census Tract 3547, Marion County, Indiana",2015,492,183,309,37.19512195121951,62.80487804878049,190,309,61.48867313915858
18097355700,"Census Tract 3557, Marion County, Indiana",2015,850,404,446,47.529411764705884,52.470588235294116,255,446,57.17488789237668
18097357400,"Census Tract 3574, Marion County, Indiana",2015,1526,713,813,46.72346002621232,53.27653997378768,415,813,51.04551045510455
18097357800,"Census Tract 3578, Marion County, Indiana",2015,706,342,364,48.44192634560906,51.55807365439094,228,364,62.637362637362635
18097358100,"Census Tract 3581, Marion County, Indiana",2015,957,389,568,40.6478578892372,59.3521421107628,425,568,74.82394366197182
18097360404,"Census Tract 3604.04, Marion County, Indiana",2015,2890,1176,1714,40.69204152249135,59.30795847750865,967,1714,56.417736289381565
18097380502,"Census Tract 3805.02, Marion County, Indiana",2015,1592,525,1067,32.97738693467337,67.02261306532664,512,1067,47.985004686035616
18097380800,"Census Tract 3808, Marion County, Indiana",2015,1066,879,187,82.45778611632271,17.5422138836773,94,187,50.26737967914438
18097380901,"Census Tract 3809.01, Marion County, Indiana",2015,1824,1632,192,89.47368421052632,10.526315789473685,66,192,34.375
18097381101,"Census Tract 3811.01, Marion County, Indiana",2015,2454,1437,1017,58.557457212713935,41.442542787286065,589,1017,57.91543756145526
18097381102,"Census Tract 3811.02, Marion County, Indiana",2015,2397,1626,771,67.83479349186483,32.16520650813517,476,771,61.73800259403372
18097381204,"Census Tract 3812.04, Marion County, Indiana",2015,1537,215,1322,13.98828887443071,86.01171112556929,794,1322,60.06051437216339
18097390300,"Census Tract 3903, Marion County, Indiana",2015,1850,1713,137,92.5945945945946,7.405405405405405,48,137,35.03649635036496
18097310106,"Census Tract 3101.06, Marion County, Indiana",2015,2016,248,1768,12.301587301587302,87.6984126984127,759,1768,42.92986425339367
18097320108,"Census Tract 3201.08, Marion County, Indiana",2015,2162,242,1920,11.193339500462535,88.80666049953747,1159,1920,60.364583333333336
18097320202,"Census Tract 3202.02, Marion County, Indiana",2015,1834,1364,470,74.37295528898582,25.627044711014175,169,470,35.95744680851064
18097320301,"Census Tract 3203.01, Marion County, Indiana",2015,1869,1316,553,70.4119850187266,29.588014981273407,153,553,27.66726943942134
18097320700,"Census Tract 3207, Marion County, Indiana",2015,972,505,467,51.95473251028807,48.04526748971193,157,467,33.61884368308351
18097330805,"Census Tract 3308.05, Marion County, Indiana",2015,1364,230,1134,16.86217008797654,83.13782991202346,581,1134,51.23456790123457
18097330806,"Census Tract 3308.06, Marion County, Indiana",2015,1443,548,895,37.97643797643798,62.02356202356202,594,895,66.36871508379889
18097340109,"Census Tract 3401.09, Marion County, Indiana",2015,529,364,165,68.80907372400756,31.19092627599244,68,165,41.21212121212121
18097340110,"Census Tract 3401.10, Marion County, Indiana",2015,2268,478,1790,21.075837742504408,78.9241622574956,963,1790,53.798882681564244
18097342600,"Census Tract 3426, Marion County, Indiana",2015,1156,599,557,51.81660899653979,48.18339100346021,323,557,57.98922800718133
18097354200,"Census Tract 3542, Marion County, Indiana",2015,3667,978,2689,26.67030269975457,73.32969730024543,903,2689,33.58125697285236
18097354500,"Census Tract 3545, Marion County, Indiana",2015,987,354,633,35.86626139817629,64.13373860182371,301,633,47.55134281200632
18097357300,"Census Tract 3573, Marion County, Indiana",2015,924,366,558,39.61038961038961,60.38961038961039,355,558,63.62007168458781
18097360405,"Census Tract 3604.05, Marion County, Indiana",2015,2111,1360,751,64.42444339175746,35.575556608242536,362,751,48.202396804260985
18097360502,"Census Tract 3605.02, Marion County, Indiana",2015,2184,1225,959,56.08974358974359,43.91025641025641,480,959,50.05213764337852
18097360800,"Census Tract 3608, Marion County, Indiana",2015,1165,378,787,32.44635193133047,67.55364806866953,534,787,67.85260482846252
18097380200,"Census Tract 3802, Marion County, Indiana",2015,1374,598,776,43.522561863173216,56.477438136826784,386,776,49.74226804123711
18097380902,"Census Tract 3809.02, Marion County, Indiana",2015,2463,1795,668,72.87860332927325,27.121396670726757,207,668,30.98802395209581
18097381203,"Census Tract 3812.03, Marion County, Indiana",2015,1137,269,868,23.658751099384343,76.34124890061565,532,868,61.29032258064516
18097320109,"Census Tract 3201.09, Marion County, Indiana",2015,1116,904,212,81.00358422939068,18.996415770609318,46,212,21.69811320754717
18097310104,"Census Tract 3101.04, Marion County, Indiana",2015,1931,1025,906,53.08130502330399,46.91869497669601,346,906,38.18984547461368
18097310308,"Census Tract 3103.08, Marion County, Indiana",2015,1196,781,415,65.3010033444816,34.69899665551839,300,415,72.28915662650603
18097320107,"Census Tract 3201.07, Marion County, Indiana",2015,780,617,163,79.1025641025641,20.897435897435898,28,163,17.177914110429448
18097340300,"Census Tract 3403, Marion County, Indiana",2016,2464,805,1659,32.67045454545455,67.32954545454545,983,1659,59.25256178420735
18097341200,"Census Tract 3412, Marion County, Indiana",2016,789,335,454,42.458808618504435,57.541191381495565,270,454,59.47136563876652
18097341600,"Census Tract 3416, Marion County, Indiana",2016,818,279,539,34.10757946210269,65.89242053789731,220,539,40.816326530612244
18097342101,"Census Tract 3421.01, Marion County, Indiana",2016,1838,1392,446,75.73449401523395,24.26550598476605,281,446,63.00448430493274
18097340400,"Census Tract 3404, Marion County, Indiana",2016,1215,553,662,45.51440329218107,54.48559670781893,356,662,53.77643504531722
18097342400,"Census Tract 3424, Marion County, Indiana",2016,661,321,340,48.56278366111952,51.43721633888048,161,340,47.35294117647059
18097342500,"Census Tract 3425, Marion County, Indiana",2016,1683,1079,604,64.11170528817587,35.88829471182412,422,604,69.86754966887418
18097350500,"Census Tract 3505, Marion County, Indiana",2016,909,403,506,44.33443344334434,55.66556655665566,269,506,53.16205533596838
18097350600,"Census Tract 3506, Marion County, Indiana",2016,1798,1019,779,56.67408231368187,43.32591768631813,519,779,66.62387676508344
18097351600,"Census Tract 3516, Marion County, Indiana",2016,930,419,511,45.053763440860216,54.946236559139784,198,511,38.74755381604697
18097354700,"Census Tract 3547, Marion County, Indiana",2016,533,196,337,36.77298311444653,63.22701688555347,213,337,63.204747774480715
18097355700,"Census Tract 3557, Marion County, Indiana",2016,879,343,536,39.021615472127415,60.978384527872585,291,536,54.291044776119406
18097357400,"Census Tract 3574, Marion County, Indiana",2016,1562,719,843,46.03072983354674,53.96927016645326,473,843,56.109134045077106
18097357800,"Census Tract 3578, Marion County, Indiana",2016,756,356,400,47.08994708994709,52.91005291005291,182,400,45.5
18097358100,"Census Tract 3581, Marion County, Indiana",2016,1019,411,608,40.333660451422965,59.666339548577035,457,608,75.16447368421052
18097360404,"Census Tract 3604.04, Marion County, Indiana",2016,2948,1115,1833,37.82225237449118,62.17774762550882,1012,1833,55.210038188761594
18097380502,"Census Tract 3805.02, Marion County, Indiana",2016,1565,530,1035,33.86581469648562,66.13418530351437,489,1035,47.2463768115942
18097380800,"Census Tract 3808, Marion County, Indiana",2016,1063,895,168,84.19567262464723,15.804327375352775,68,168,40.476190476190474
18097380901,"Census Tract 3809.01, Marion County, Indiana",2016,1851,1642,209,88.70880605078337,11.29119394921664,64,209,30.62200956937799
18097381101,"Census Tract 3811.01, Marion County, Indiana",2016,2483,1475,1008,59.40394683850181,40.59605316149819,554,1008,54.96031746031746
18097381102,"Census Tract 3811.02, Marion County, Indiana",2016,2429,1722,707,70.89337175792507,29.10662824207493,465,707,65.77086280056577
18097381204,"Census Tract 3812.04, Marion County, Indiana",2016,1528,212,1316,13.87434554973822,86.12565445026178,752,1316,57.142857142857146
18097390300,"Census Tract 3903, Marion County, Indiana",2016,1867,1707,160,91.43010176754152,8.56989823245849,49,160,30.625
18097310106,"Census Tract 3101.06, Marion County, Indiana",2016,2053,243,1810,11.836337067705797,88.1636629322942,813,1810,44.9171270718232
18097320108,"Census Tract 3201.08, Marion County, Indiana",2016,2153,223,1930,10.357640501625639,89.64235949837436,1068,1930,55.33678756476684
18097320202,"Census Tract 3202.02, Marion County, Indiana",2016,1885,1289,596,68.38196286472149,31.618037135278513,152,596,25.503355704697988
18097320301,"Census Tract 3203.01, Marion County, Indiana",2016,1860,1340,520,72.04301075268818,27.956989247311828,128,520,24.615384615384617
18097320700,"Census Tract 3207, Marion County, Indiana",2016,1018,563,455,55.30451866404715,44.69548133595285,142,455,31.208791208791208
18097354200,"Census Tract 3542, Marion County, Indiana",2016,3872,1032,2840,26.65289256198347,73.34710743801652,1015,2840,35.73943661971831
18097354500,"Census Tract 3545, Marion County, Indiana",2016,980,382,598,38.97959183673469,61.02040816326531,275,598,45.986622073578594
18097357300,"Census Tract 3573, Marion County, Indiana",2016,965,358,607,37.09844559585492,62.90155440414508,404,607,66.55683690280065
18097360405,"Census Tract 3604.05, Marion County, Indiana",2016,2148,1417,731,65.9683426443203,34.031657355679705,423,731,57.86593707250342
18097360502,"Census Tract 3605.02, Marion County, Indiana",2016,2213,1331,882,60.14460009037506,39.85539990962494,506,882,57.36961451247166
18097360800,"Census Tract 3608, Marion County, Indiana",2016,1157,362,795,31.28781331028522,68.71218668971478,555,795,69.81132075471699
18097380200,"Census Tract 3802, Marion County, Indiana",2016,1426,631,795,44.249649368863956,55.750350631136044,366,795,46.0377358490566
18097380902,"Census Tract 3809.02, Marion County, Indiana",2016,2409,1816,593,75.38397675383976,24.616023246160232,201,593,33.895446880269816
18097381203,"Census Tract 3812.03, Marion County, Indiana",2016,1068,273,795,25.56179775280899,74.43820224719101,422,795,53.081761006289305
18097320109,"Census Tract 3201.09, Marion County, Indiana",2016,1177,927,250,78.75955819881054,21.240441801189466,62,250,24.8
18097310104,"Census Tract 3101.04, Marion County, Indiana",2016,1937,1023,914,52.81362932369644,47.18637067630356,406,914,44.42013129102845
18097310308,"Census Tract 3103.08, Marion County, Indiana",2016,1182,761,421,64.3824027072758,35.6175972927242,227,421,53.919239904988125
18097320107,"Census Tract 3201.07, Marion County, Indiana",2016,796,658,138,82.66331658291458,17.33668341708543,37,138,26.81159420289855
18097361100,"Census Tract 3611, Marion County, Indiana",2016,1488,742,746,49.865591397849464,50.134408602150536,348,746,46.64879356568365
18097370201,"Census Tract 3702.01, Marion County, Indiana",2016,1537,670,867,43.59141184124919,56.40858815875081,361,867,41.63783160322953
18097381002,"Census Tract 3810.02, Marion County, Indiana",2016,1121,967,154,86.26226583407671,13.737734165923284,68,154,44.15584415584416
18097390200,"Census Tract 3902, Marion County, Indiana",2016,1189,917,272,77.12363330529857,22.87636669470143,167,272,61.39705882352941
18097390403,"Census Tract 3904.03, Marion County, Indiana",2016,3292,3091,201,93.89428918590522,6.105710814094775,67,201,33.333333333333336
18097310103,"Census Tract 3101.03, Marion County, Indiana",2016,2498,2113,385,84.58767013610888,15.412329863891113,182,385,47.27272727272727
18097310105,"Census Tract 3101.05, Marion County, Indiana",2016,1608,878,730,54.601990049751244,45.398009950248756,301,730,41.23287671232877
18097310108,"Census Tract 3101.08, Marion County, Indiana",2016,1456,1257,199,86.33241758241758,13.667582417582418,67,199,33.66834170854271
18097320203,"Census Tract 3202.03, Marion County, Indiana",2016,1759,303,1456,17.225696418419556,82.77430358158044,615,1456,42.239010989010985
18097320500,"Census Tract 3205, Marion County, Indiana",2016,1435,779,656,54.285714285714285,45.714285714285715,210,656,32.01219512195122
18097320901,"Census Tract 3209.01, Marion County, Indiana",2016,2577,1788,789,69.38300349243306,30.616996507566938,477,789,60.456273764258555
18097320800,"Census Tract 3208, Marion County, Indiana",2016,1184,1067,117,90.11824324324324,9.881756756756756,34,117,29.05982905982906
18097321200,"Census Tract 3212, Marion County, Indiana",2016,2085,1684,401,80.7673860911271,19.232613908872903,74,401,18.453865336658353
18097330401,"Census Tract 3304.01, Marion County, Indiana",2016,2145,1541,604,71.84149184149184,28.15850815850816,337,604,55.794701986754966
18097330900,"Census Tract 3309, Marion County, Indiana",2016,2031,607,1424,29.886755292959133,70.11324470704086,728,1424,51.12359550561798
18097340101,"Census Tract 3401.01, Marion County, Indiana",2016,1385,1130,255,81.5884476534296,18.411552346570396,116,255,45.490196078431374
18097340600,"Census Tract 3406, Marion County, Indiana",2016,1797,926,871,51.53032832498609,48.46967167501391,605,871,69.46039035591275
18097341100,"Census Tract 3411, Marion County, Indiana",2016,746,373,373,50,50,243,373,65.14745308310992
18097342000,"Census Tract 3420, Marion County, Indiana",2016,2116,1870,246,88.3742911153119,11.625708884688091,118,246,47.96747967479675
18097350800,"Census Tract 3508, Marion County, Indiana",2016,885,190,695,21.468926553672315,78.53107344632768,402,695,57.84172661870504
18097351200,"Census Tract 3512, Marion County, Indiana",2016,881,329,552,37.34392735527809,62.65607264472191,375,552,67.93478260869566
18097352100,"Census Tract 3521, Marion County, Indiana",2016,770,351,419,45.58441558441559,54.41558441558441,296,419,70.64439140811456
18097356200,"Census Tract 3562, Marion County, Indiana",2016,843,305,538,36.1803084223013,63.8196915776987,214,538,39.77695167286245
18097357900,"Census Tract 3579, Marion County, Indiana",2016,1625,973,652,59.87692307692308,40.12307692307692,410,652,62.88343558282209
18097360101,"Census Tract 3601.01, Marion County, Indiana",2016,938,270,668,28.784648187633262,71.21535181236673,417,668,62.4251497005988
18097360402,"Census Tract 3604.02, Marion County, Indiana",2016,632,295,337,46.677215189873415,53.322784810126585,233,337,69.13946587537092
18097360700,"Census Tract 3607, Marion County, Indiana",2016,805,649,156,80.62111801242236,19.37888198757764,56,156,35.8974358974359
18097360900,"Census Tract 3609, Marion County, Indiana",2016,2256,1295,961,57.402482269503544,42.597517730496456,635,961,66.07700312174818
18097361000,"Census Tract 3610, Marion County, Indiana",2016,899,734,165,81.64627363737486,18.35372636262514,54,165,32.72727272727273
18097310201,"Census Tract 3102.01, Marion County, Indiana",2016,1309,775,534,59.20550038197097,40.79449961802903,400,534,74.90636704119851
18097352500,"Census Tract 3525, Marion County, Indiana",2016,1356,828,528,61.06194690265487,38.93805309734513,340,528,64.39393939393939
18097352800,"Census Tract 3528, Marion County, Indiana",2016,443,182,261,41.08352144469526,58.91647855530474,159,261,60.91954022988506
18097353600,"Census Tract 3536, Marion County, Indiana",2016,854,322,532,37.704918032786885,62.295081967213115,344,532,64.66165413533835
18097354900,"Census Tract 3549, Marion County, Indiana",2016,1027,377,650,36.70886075949367,63.29113924050633,419,650,64.46153846153847
18097355900,"Census Tract 3559, Marion County, Indiana",2016,921,443,478,48.099891422366994,51.900108577633006,246,478,51.46443514644351
18097357000,"Census Tract 3570, Marion County, Indiana",2016,894,415,479,46.42058165548099,53.57941834451901,318,479,66.38830897703549
18097360102,"Census Tract 3601.02, Marion County, Indiana",2016,1040,423,617,40.67307692307692,59.32692307692308,303,617,49.10858995137763
18097380700,"Census Tract 3807, Marion County, Indiana",2016,2225,959,1266,43.10112359550562,56.89887640449438,752,1266,59.39968404423381
18097361400,"Census Tract 3614, Marion County, Indiana",2016,4039,2744,1295,67.93760831889081,32.06239168110918,398,1295,30.733590733590734
18097361600,"Census Tract 3616, Marion County, Indiana",2016,3007,2892,115,96.1755902893249,3.8244097106750914,78,115,67.82608695652173
18097310110,"Census Tract 3101.10, Marion County, Indiana",2016,1338,635,703,47.458893871449924,52.541106128550076,276,703,39.26031294452347
18097310111,"Census Tract 3101.11, Marion County, Indiana",2016,1705,670,1035,39.29618768328446,60.70381231671554,401,1035,38.743961352657
18097310204,"Census Tract 3102.04, Marion County, Indiana",2016,1850,1115,735,60.270270270270274,39.729729729729726,449,735,61.08843537414966
18097310310,"Census Tract 3103.10, Marion County, Indiana",2016,1575,1126,449,71.4920634920635,28.50793650793651,237,449,52.783964365256125
18097310203,"Census Tract 3102.03, Marion County, Indiana",2016,2287,1340,947,58.59204197638828,41.40795802361172,474,947,50.052798310454065
18097310309,"Census Tract 3103.09, Marion County, Indiana",2016,1537,307,1230,19.973975276512686,80.02602472348731,537,1230,43.65853658536585
18097310311,"Census Tract 3103.11, Marion County, Indiana",2016,1833,1731,102,94.43535188216039,5.5646481178396074,57,102,55.88235294117647
18097310312,"Census Tract 3103.12, Marion County, Indiana",2016,2481,886,1595,35.71140669085047,64.28859330914953,813,1595,50.9717868338558
18097330108,"Census Tract 3301.08, Marion County, Indiana",2016,1461,1416,45,96.91991786447639,3.080082135523614,0,45,0
18097330109,"Census Tract 3301.09, Marion County, Indiana",2016,2143,1917,226,89.45403639757349,10.545963602426506,17,226,7.522123893805309
18097330206,"Census Tract 3302.06, Marion County, Indiana",2016,1762,1606,156,91.14642451759364,8.853575482406356,45,156,28.846153846153847
18097330209,"Census Tract 3302.09, Marion County, Indiana",2016,3325,2676,649,80.4812030075188,19.518796992481203,318,649,48.99845916795069
18097330208,"Census Tract 3302.08, Marion County, Indiana",2016,1244,1048,196,84.2443729903537,15.755627009646302,98,196,50
18097330803,"Census Tract 3308.03, Marion County, Indiana",2016,1302,339,963,26.036866359447004,73.963133640553,619,963,64.27829698857737
18097330804,"Census Tract 3308.04, Marion County, Indiana",2016,1268,220,1048,17.350157728706623,82.64984227129338,470,1048,44.847328244274806
18097330805,"Census Tract 3308.05, Marion County, Indiana",2016,1360,214,1146,15.735294117647058,84.26470588235294,500,1146,43.63001745200698
18097330806,"Census Tract 3308.06, Marion County, Indiana",2016,1550,559,991,36.064516129032256,63.935483870967744,554,991,55.90312815338042
18097340109,"Census Tract 3401.09, Marion County, Indiana",2016,530,324,206,61.132075471698116,38.867924528301884,82,206,39.80582524271845
18097340110,"Census Tract 3401.10, Marion County, Indiana",2016,2296,598,1698,26.045296167247386,73.95470383275261,806,1698,47.467608951707895
18097342600,"Census Tract 3426, Marion County, Indiana",2016,1103,518,585,46.962828649138714,53.037171350861286,370,585,63.24786324786325
18097380300,"Census Tract 3803, Marion County, Indiana",2016,1735,825,910,47.55043227665706,52.44956772334294,398,910,43.73626373626374
18097381001,"Census Tract 3810.01, Marion County, Indiana",2016,2992,797,2195,26.637700534759357,73.36229946524064,1016,2195,46.287015945330296
18097380100,"Census Tract 3801, Marion County, Indiana",2016,6493,4577,1916,70.49129832126906,29.50870167873094,761,1916,39.718162839248436
18097381201,"Census Tract 3812.01, Marion County, Indiana",2016,2953,2131,822,72.16390111750762,27.83609888249238,336,822,40.87591240875913
18097381205,"Census Tract 3812.05, Marion County, Indiana",2016,2518,929,1589,36.894360603653695,63.105639396346305,930,1589,58.52737570799245
18097321400,"Census Tract 3214, Marion County, Indiana",2016,2531,1610,921,63.61122086131964,36.38877913868036,254,921,27.578718783930512
18097322300,"Census Tract 3223, Marion County, Indiana",2016,1111,780,331,70.20702070207021,29.792979297929794,84,331,25.377643504531722
18097330105,"Census Tract 3301.05, Marion County, Indiana",2016,2472,822,1650,33.25242718446602,66.74757281553399,465,1650,28.181818181818183
18097340108,"Census Tract 3401.08, Marion County, Indiana",2016,823,153,670,18.59052247873633,81.40947752126367,398,670,59.40298507462686
18097350400,"Census Tract 3504, Marion County, Indiana",2016,1038,478,560,46.05009633911368,53.94990366088632,380,560,67.85714285714286
18097350700,"Census Tract 3507, Marion County, Indiana",2016,595,375,220,63.02521008403362,36.97478991596638,132,220,60
18097350900,"Census Tract 3509, Marion County, Indiana",2016,503,218,285,43.33996023856859,56.66003976143141,152,285,53.333333333333336
18097351700,"Census Tract 3517, Marion County, Indiana",2016,979,460,519,46.986721144024514,53.013278855975486,306,519,58.959537572254334
18097322400,"Census Tract 3224, Marion County, Indiana",2016,1346,621,725,46.13670133729569,53.86329866270431,294,725,40.55172413793103
18097330106,"Census Tract 3301.06, Marion County, Indiana",2016,2490,392,2098,15.742971887550201,84.2570281124498,1151,2098,54.86177311725453
18097330107,"Census Tract 3301.07, Marion County, Indiana",2016,2462,2412,50,97.96913078797725,2.0308692120227456,0,50,0
18097320105,"Census Tract 3201.05, Marion County, Indiana",2016,1938,978,960,50.46439628482972,49.53560371517028,374,960,38.958333333333336
18097320204,"Census Tract 3202.04, Marion County, Indiana",2016,2694,549,2145,20.378619153674833,79.62138084632517,1062,2145,49.51048951048951
18097320600,"Census Tract 3206, Marion County, Indiana",2016,1124,805,319,71.61921708185054,28.380782918149468,146,319,45.76802507836991
18097321700,"Census Tract 3217, Marion County, Indiana",2016,2027,1270,757,62.65416872224963,37.34583127775037,227,757,29.98678996036988
18097330202,"Census Tract 3302.02, Marion County, Indiana",2016,3978,2324,1654,58.421317244846655,41.578682755153345,904,1654,54.65538089480049
18097340111,"Census Tract 3401.11, Marion County, Indiana",2016,990,745,245,75.25252525252525,24.747474747474747,65,245,26.53061224489796
18097340112,"Census Tract 3401.12, Marion County, Indiana",2016,2436,1054,1382,43.26765188834155,56.73234811165845,630,1382,45.58610709117222
18097340113,"Census Tract 3401.13, Marion County, Indiana",2016,1571,1028,543,65.43602800763844,34.56397199236155,449,543,82.68876611418048
18097340114,"Census Tract 3401.14, Marion County, Indiana",2016,1526,1322,204,86.63171690694627,13.368283093053735,91,204,44.6078431372549
18097340201,"Census Tract 3402.01, Marion County, Indiana",2016,1039,694,345,66.79499518768046,33.20500481231954,139,345,40.289855072463766
18097340202,"Census Tract 3402.02, Marion County, Indiana",2016,1788,589,1199,32.94183445190156,67.05816554809843,625,1199,52.12677231025855
18097340902,"Census Tract 3409.02, Marion County, Indiana",2016,2835,587,2248,20.705467372134038,79.29453262786596,982,2248,43.68327402135231
18097341904,"Census Tract 3419.04, Marion County, Indiana",2016,897,246,651,27.4247491638796,72.5752508361204,319,651,49.00153609831029
18097370301,"Census Tract 3703.01, Marion County, Indiana",2016,3123,2591,532,82.96509766250401,17.034902337495996,195,532,36.65413533834587
18097340901,"Census Tract 3409.01, Marion County, Indiana",2016,1371,1184,187,86.36032093362509,13.639679066374908,37,187,19.78609625668449
18097341903,"Census Tract 3419.03, Marion County, Indiana",2016,2127,339,1788,15.937940761636106,84.06205923836389,950,1788,53.131991051454136
18097370302,"Census Tract 3703.02, Marion County, Indiana",2016,2958,2322,636,78.49898580121703,21.50101419878296,300,636,47.16981132075472
18097380403,"Census Tract 3804.03, Marion County, Indiana",2016,1466,947,519,64.59754433833561,35.40245566166439,245,519,47.20616570327553
18097321002,"Census Tract 3210.02, Marion County, Indiana",2016,1804,1293,511,71.6740576496674,28.325942350332593,204,511,39.92172211350294
18097380600,"Census Tract 3806, Marion County, Indiana",2016,2182,984,1198,45.096241979835014,54.903758020164986,715,1198,59.68280467445743
18097321800,"Census Tract 3218, Marion County, Indiana",2016,1620,1112,508,68.64197530864197,31.358024691358025,138,508,27.165354330708663
18097322200,"Census Tract 3222, Marion County, Indiana",2016,783,545,238,69.60408684546616,30.395913154533844,111,238,46.63865546218487
18097330203,"Census Tract 3302.03, Marion County, Indiana",2016,2067,1994,73,96.46831156265118,3.531688437348815,0,73,0
18097341902,"Census Tract 3419.02, Marion County, Indiana",2016,1403,1123,280,80.04276550249466,19.957234497505347,140,280,50
18097330204,"Census Tract 3302.04, Marion County, Indiana",2016,2149,1781,368,82.87575616565844,17.124243834341556,28,368,7.608695652173913
18097330500,"Census Tract 3305, Marion County, Indiana",2016,2550,1491,1059,58.470588235294116,41.529411764705884,542,1059,51.18035882908404
18097352300,"Census Tract 3523, Marion County, Indiana",2016,540,249,291,46.111111111111114,53.888888888888886,151,291,51.89003436426117
18097355100,"Census Tract 3551, Marion County, Indiana",2016,710,227,483,31.971830985915492,68.02816901408451,304,483,62.939958592132506
18097355300,"Census Tract 3553, Marion County, Indiana",2016,1053,493,560,46.81861348528015,53.18138651471985,290,560,51.785714285714285
18097360602,"Census Tract 3606.02, Marion County, Indiana",2016,2442,1167,1275,47.78869778869779,52.21130221130221,802,1275,62.90196078431372
18097352600,"Census Tract 3526, Marion County, Indiana",2016,1251,557,694,44.524380495603516,55.475619504396484,392,694,56.48414985590778
18097353500,"Census Tract 3535, Marion County, Indiana",2016,1105,141,964,12.760180995475114,87.23981900452489,471,964,48.85892116182573
18097354800,"Census Tract 3548, Marion County, Indiana",2016,654,177,477,27.06422018348624,72.93577981651376,310,477,64.98951781970649
18097355000,"Census Tract 3550, Marion County, Indiana",2016,818,307,511,37.530562347188265,62.469437652811735,315,511,61.64383561643836
18097357500,"Census Tract 3575, Marion County, Indiana",2016,1567,1152,415,73.51627313337588,26.48372686662412,196,415,47.2289156626506
18097357600,"Census Tract 3576, Marion County, Indiana",2016,2416,1265,1151,52.359271523178805,47.640728476821195,788,1151,68.4622067767159
18097360202,"Census Tract 3602.02, Marion County, Indiana",2016,1185,787,398,66.41350210970464,33.586497890295355,288,398,72.36180904522612
18097310306,"Census Tract 3103.06, Marion County, Indiana",2016,2127,541,1586,25.43488481429243,74.56511518570757,911,1586,57.44010088272383
18097320304,"Census Tract 3203.04, Marion County, Indiana",2016,2952,1832,1120,62.05962059620596,37.94037940379404,434,1120,38.75
18097321001,"Census Tract 3210.01, Marion County, Indiana",2016,1016,765,251,75.29527559055119,24.70472440944882,91,251,36.254980079681275
18097356400,"Census Tract 3564, Marion County, Indiana",2016,1509,594,915,39.363817097415506,60.636182902584494,510,915,55.73770491803279
18097354400,"Census Tract 3544, Marion County, Indiana",2016,710,370,340,52.11267605633803,47.88732394366197,159,340,46.76470588235294
18097331000,"Census Tract 3310, Marion County, Indiana",2016,1636,1052,584,64.30317848410758,35.696821515892424,295,584,50.513698630136986
18097340500,"Census Tract 3405, Marion County, Indiana",2016,1701,491,1210,28.865373309817755,71.13462669018224,676,1210,55.86776859504132
18097340700,"Census Tract 3407, Marion County, Indiana",2016,1295,535,760,41.31274131274131,58.68725868725869,370,760,48.68421052631579
18097341700,"Census Tract 3417, Marion County, Indiana",2016,1684,823,861,48.87173396674584,51.12826603325416,605,861,70.267131242741
18097350300,"Census Tract 3503, Marion County, Indiana",2016,1358,139,1219,10.235640648011781,89.76435935198822,735,1219,60.29532403609516
18097351900,"Census Tract 3519, Marion County, Indiana",2016,1048,558,490,53.2442748091603,46.7557251908397,190,490,38.775510204081634
18097355400,"Census Tract 3554, Marion County, Indiana",2016,1298,392,906,30.20030816640986,69.79969183359015,508,906,56.07064017660044
18097355500,"Census Tract 3555, Marion County, Indiana",2016,1377,728,649,52.868554829339146,47.131445170660854,252,649,38.82896764252696
18097356900,"Census Tract 3569, Marion County, Indiana",2016,994,448,546,45.070422535211264,54.929577464788736,281,546,51.46520146520147
18097357200,"Census Tract 3572, Marion County, Indiana",2016,900,447,453,49.666666666666664,50.333333333333336,314,453,69.31567328918322
18097358000,"Census Tract 3580, Marion County, Indiana",2016,466,308,158,66.09442060085837,33.90557939914163,45,158,28.481012658227847
18097360301,"Census Tract 3603.01, Marion County, Indiana",2016,1274,635,639,49.84301412872841,50.15698587127159,269,639,42.09702660406886
18097360401,"Census Tract 3604.01, Marion County, Indiana",2016,2263,628,1635,27.750773309765798,72.2492266902342,885,1635,54.12844036697248
18097380501,"Census Tract 3805.01, Marion County, Indiana",2016,974,663,311,68.06981519507187,31.930184804928132,163,311,52.41157556270097
18097390402,"Census Tract 3904.02, Marion County, Indiana",2016,4157,3326,831,80.00962232379119,19.990377676208805,277,831,33.333333333333336
18097321300,"Census Tract 3213, Marion County, Indiana",2016,1216,675,541,55.50986842105263,44.49013157894737,177,541,32.71719038817005
18097330103,"Census Tract 3301.03, Marion County, Indiana",2016,2590,1541,1049,59.4980694980695,40.5019305019305,416,1049,39.65681601525262
18097330600,"Census Tract 3306, Marion County, Indiana",2016,1915,1095,820,57.180156657963444,42.819843342036556,420,820,51.21951219512195
18097322600,"Census Tract 3226, Marion County, Indiana",2016,1891,356,1535,18.82601797990481,81.17398202009518,838,1535,54.5928338762215
18097321100,"Census Tract 3211, Marion County, Indiana",2016,1495,1048,447,70.10033444816054,29.899665551839465,167,447,37.360178970917225
18097320400,"Census Tract 3204, Marion County, Indiana",2016,1401,633,768,45.18201284796574,54.81798715203426,340,768,44.270833333333336
18097340800,"Census Tract 3408, Marion County, Indiana",2016,680,528,152,77.6470588235294,22.352941176470587,84,152,55.26315789473684
18097351500,"Census Tract 3515, Marion County, Indiana",2016,792,203,589,25.63131313131313,74.36868686868686,262,589,44.48217317487266
18097320903,"Census Tract 3209.03, Marion County, Indiana",2016,1676,516,1160,30.787589498806682,69.21241050119332,560,1160,48.275862068965516
18097360601,"Census Tract 3606.01, Marion County, Indiana",2016,1929,1416,513,73.4059097978227,26.594090202177295,165,513,32.16374269005848
18097320106,"Census Tract 3201.06, Marion County, Indiana",2016,999,625,374,62.56256256256256,37.43743743743744,165,374,44.11764705882353
18097322500,"Census Tract 3225, Marion County, Indiana",2016,689,150,539,21.77068214804064,78.22931785195937,260,539,48.23747680890538
18097342200,"Census Tract 3422, Marion County, Indiana",2016,1967,930,1037,47.2801220132181,52.7198779867819,489,1037,47.155255544840884
18097355600,"Census Tract 3556, Marion County, Indiana",2016,740,383,357,51.75675675675676,48.24324324324324,248,357,69.46778711484593
18097310305,"Census Tract 3103.05, Marion County, Indiana",2016,2446,857,1589,35.03679476696647,64.96320523303352,778,1589,48.96161107614852
18097322100,"Census Tract 3221, Marion County, Indiana",2016,1075,634,441,58.97674418604651,41.02325581395349,231,441,52.38095238095238
18097342300,"Census Tract 3423, Marion County, Indiana",2016,2464,1307,1157,53.04383116883117,46.95616883116883,714,1157,61.71132238547969
18097353300,"Census Tract 3533, Marion County, Indiana",2016,1679,198,1481,11.79273377010125,88.20726622989875,598,1481,40.37812288993923
18097357100,"Census Tract 3571, Marion County, Indiana",2016,845,341,504,40.35502958579882,59.64497041420118,325,504,64.48412698412699
18097370202,"Census Tract 3702.02, Marion County, Indiana",2016,2451,1254,1197,51.16279069767442,48.83720930232558,803,1197,67.0843776106934
18097360302,"Census Tract 3603.02, Marion County, Indiana",2016,910,253,657,27.802197802197803,72.1978021978022,380,657,57.83866057838661
18097361200,"Census Tract 3612, Marion County, Indiana",2016,1436,776,660,54.03899721448468,45.96100278551532,367,660,55.60606060606061
18097361300,"Census Tract 3613, Marion County, Indiana",2016,928,714,214,76.9396551724138,23.060344827586206,81,214,37.850467289719624
18097380402,"Census Tract 3804.02, Marion County, Indiana",2016,1892,504,1388,26.6384778012685,73.3615221987315,687,1388,49.4956772334294
18097360201,"Census Tract 3602.01, Marion County, Indiana",2016,1536,622,914,40.494791666666664,59.505208333333336,407,914,44.52954048140044
18097360501,"Census Tract 3605.01, Marion County, Indiana",2016,2211,1317,894,59.56580732700136,40.43419267299864,337,894,37.695749440715886
18097320303,"Census Tract 3203.03, Marion County, Indiana",2016,1862,0,1862,0,100,546,1862,29.32330827067669
18097320902,"Census Tract 3209.02, Marion County, Indiana",2016,1667,523,1144,31.37372525494901,68.62627474505099,728,1144,63.63636363636363
18097321600,"Census Tract 3216, Marion County, Indiana",2016,2256,1068,1188,47.340425531914896,52.659574468085104,676,1188,56.9023569023569
18097380404,"Census Tract 3804.04, Marion County, Indiana",2016,1598,1054,544,65.95744680851064,34.04255319148936,297,544,54.595588235294116
18097390101,"Census Tract 3901.01, Marion County, Indiana",2016,2872,2485,387,86.525069637883007,13.474930362116991,155,387,40.05167958656331
18097390102,"Census Tract 3901.02, Marion County, Indiana",2016,2063,821,1242,39.79641299079011,60.20358700920989,692,1242,55.71658615136876
18097390404,"Census Tract 3904.04, Marion County, Indiana",2016,2193,1632,561,74.4186046511628,25.58139534883721,272,561,48.484848484848484
18097390405,"Census Tract 3904.05, Marion County, Indiana",2016,1752,489,1263,27.910958904109588,72.08904109589041,348,1263,27.553444180522565
18097390500,"Census Tract 3905, Marion County, Indiana",2016,961,471,490,49.011446409989595,50.988553590010405,231,490,47.142857142857146
18097390600,"Census Tract 3906, Marion County, Indiana",2016,2564,526,2038,20.514820592823714,79.48517940717629,993,2038,48.72423945044161
18097390700,"Census Tract 3907, Marion County, Indiana",2016,879,378,501,43.003412969283275,56.996587030716725,331,501,66.06786427145708
18097390800,"Census Tract 3908, Marion County, Indiana",2016,1384,855,529,61.77745664739884,38.22254335260116,171,529,32.32514177693762
18097390900,"Census Tract 3909, Marion County, Indiana",2016,1185,418,767,35.27426160337553,64.72573839662448,277,767,36.11473272490222
18097391000,"Census Tract 3910, Marion County, Indiana",2016,2869,266,2603,9.271523178807946,90.72847682119205,1169,2603,44.90971955436035
18097321900,"Census Tract 3219, Marion County, Indiana",2016,1242,919,323,73.99355877616748,26.006441223832528,147,323,45.5108359133127
18097322000,"Census Tract 3220, Marion County, Indiana",2016,1515,760,755,50.165016501650165,49.834983498349835,291,755,38.54304635761589
18097322700,"Census Tract 3227, Marion County, Indiana",2016,893,618,275,69.20492721164614,30.795072788353863,172,275,62.54545454545455
18097340102,"Census Tract 3401.02, Marion County, Indiana",2016,1576,303,1273,19.225888324873097,80.7741116751269,854,1273,67.08562450903378
18097341000,"Census Tract 3410, Marion County, Indiana",2016,767,581,186,75.7496740547588,24.2503259452412,65,186,34.946236559139784
18097351000,"Census Tract 3510, Marion County, Indiana",2016,1100,386,714,35.09090909090909,64.9090909090909,406,714,56.86274509803921
18097352400,"Census Tract 3524, Marion County, Indiana",2016,1339,559,780,41.74757281553398,58.25242718446602,525,780,67.3076923076923
18097352700,"Census Tract 3527, Marion County, Indiana",2016,1032,364,668,35.27131782945737,64.72868217054264,260,668,38.92215568862275
18097330700,"Census Tract 3307, Marion County, Indiana",2016,2536,1626,910,64.1167192429022,35.88328075709779,195,910,21.428571428571427
18097350100,"Census Tract 3501, Marion County, Indiana",2016,612,316,296,51.63398692810458,48.366013071895424,175,296,59.12162162162162
18097354200,"Census Tract 3542, Marion County, Indiana",2017,4146,1187,2959,28.630004823926676,71.36999517607332,1163,2959,39.303818857722206
18097354500,"Census Tract 3545, Marion County, Indiana",2017,1021,396,625,38.78550440744368,61.21449559255632,332,625,53.12
18097357300,"Census Tract 3573, Marion County, Indiana",2017,931,325,606,34.908700322234154,65.09129967776585,403,606,66.5016501650165
18097360405,"Census Tract 3604.05, Marion County, Indiana",2017,2308,1463,845,63.38821490467937,36.61178509532063,403,845,47.69230769230769
18097360502,"Census Tract 3605.02, Marion County, Indiana",2017,2323,1413,910,60.826517434352134,39.173482565647866,581,910,63.84615384615385
18097360800,"Census Tract 3608, Marion County, Indiana",2017,1264,435,829,34.414556962025316,65.58544303797468,570,829,68.75753920386008
18097380300,"Census Tract 3803, Marion County, Indiana",2017,1757,861,896,49.00398406374502,50.99601593625498,492,896,54.910714285714285
18097381001,"Census Tract 3810.01, Marion County, Indiana",2017,2850,803,2047,28.17543859649123,71.82456140350877,969,2047,47.33756717147045
18097380100,"Census Tract 3801, Marion County, Indiana",2017,6601,4538,2063,68.74715952128466,31.252840478715346,816,2063,39.55404750363548
18097381201,"Census Tract 3812.01, Marion County, Indiana",2017,2887,2100,787,72.73986837547628,27.260131624523726,303,787,38.50063532401525
18097381205,"Census Tract 3812.05, Marion County, Indiana",2017,2549,1002,1547,39.309533150255,60.690466849745,685,1547,44.2792501616031
18097321400,"Census Tract 3214, Marion County, Indiana",2017,2533,1709,824,67.46940386893013,32.53059613106988,227,824,27.54854368932039
18097322300,"Census Tract 3223, Marion County, Indiana",2017,1110,804,306,72.43243243243244,27.56756756756757,67,306,21.895424836601308
18097330105,"Census Tract 3301.05, Marion County, Indiana",2017,2484,742,1742,29.871175523349436,70.12882447665056,453,1742,26.00459242250287
18097340108,"Census Tract 3401.08, Marion County, Indiana",2017,819,139,680,16.971916971916972,83.02808302808303,385,680,56.61764705882353
18097350400,"Census Tract 3504, Marion County, Indiana",2017,1004,570,434,56.77290836653386,43.22709163346614,307,434,70.73732718894009
18097350700,"Census Tract 3507, Marion County, Indiana",2017,605,396,209,65.45454545454545,34.54545454545455,120,209,57.41626794258373
18097350900,"Census Tract 3509, Marion County, Indiana",2017,550,294,256,53.45454545454545,46.54545454545455,126,256,49.21875
18097351700,"Census Tract 3517, Marion County, Indiana",2017,978,485,493,49.59100204498978,50.40899795501022,272,493,55.172413793103445
18097352600,"Census Tract 3526, Marion County, Indiana",2017,1310,614,696,46.87022900763359,53.12977099236641,371,696,53.304597701149426
18097353500,"Census Tract 3535, Marion County, Indiana",2017,1129,129,1000,11.426040744021257,88.57395925597874,480,1000,48
18097354800,"Census Tract 3548, Marion County, Indiana",2017,596,211,385,35.40268456375839,64.59731543624162,241,385,62.5974025974026
18097355000,"Census Tract 3550, Marion County, Indiana",2017,846,322,524,38.061465721040186,61.938534278959814,277,524,52.86259541984733
18097357500,"Census Tract 3575, Marion County, Indiana",2017,1545,1157,388,74.88673139158576,25.113268608414238,206,388,53.09278350515464
18097357600,"Census Tract 3576, Marion County, Indiana",2017,2429,1122,1307,46.191848497324,53.808151502676,858,1307,65.64651874521806
18097310110,"Census Tract 3101.10, Marion County, Indiana",2017,1353,641,712,47.37620103473762,52.62379896526238,274,712,38.48314606741573
18097310111,"Census Tract 3101.11, Marion County, Indiana",2017,1743,674,1069,38.668961560527826,61.331038439472174,489,1069,45.74368568755847
18097310203,"Census Tract 3102.03, Marion County, Indiana",2017,2263,1340,923,59.21343349536014,40.78656650463986,441,923,47.77898158179848
18097310204,"Census Tract 3102.04, Marion County, Indiana",2017,1782,1006,776,56.45342312008979,43.54657687991021,373,776,48.06701030927835
18097310309,"Census Tract 3103.09, Marion County, Indiana",2017,1552,330,1222,21.262886597938145,78.73711340206185,517,1222,42.30769230769231
18097310310,"Census Tract 3103.10, Marion County, Indiana",2017,1579,1203,376,76.18746041798607,23.812539582013933,211,376,56.11702127659574
18097310311,"Census Tract 3103.11, Marion County, Indiana",2017,1808,1667,141,92.20132743362832,7.798672566371682,79,141,56.02836879432624
18097310312,"Census Tract 3103.12, Marion County, Indiana",2017,2380,915,1465,38.445378151260506,61.554621848739494,719,1465,49.07849829351536
18097330108,"Census Tract 3301.08, Marion County, Indiana",2017,1472,1406,66,95.5163043478261,4.483695652173913,3,66,4.545454545454546
18097330109,"Census Tract 3301.09, Marion County, Indiana",2017,2143,1975,168,92.16052263182455,7.839477368175455,36,168,21.428571428571427
18097330206,"Census Tract 3302.06, Marion County, Indiana",2017,1789,1629,160,91.05645612073785,8.943543879262158,72,160,45
18097330208,"Census Tract 3302.08, Marion County, Indiana",2017,1259,1150,109,91.34233518665607,8.657664813343924,56,109,51.37614678899082
18097330209,"Census Tract 3302.09, Marion County, Indiana",2017,3372,2733,639,81.04982206405694,18.95017793594306,363,639,56.8075117370892
18097330803,"Census Tract 3308.03, Marion County, Indiana",2017,1314,353,961,26.864535768645357,73.13546423135465,591,961,61.49843912591051
18097330804,"Census Tract 3308.04, Marion County, Indiana",2017,1238,199,1039,16.074313408723746,83.92568659127625,511,1039,49.181905678537056
18097330805,"Census Tract 3308.05, Marion County, Indiana",2017,1362,236,1126,17.32745961820852,82.67254038179148,565,1126,50.177619893428066
18097330806,"Census Tract 3308.06, Marion County, Indiana",2017,1649,499,1150,30.260764099454214,69.73923590054578,659,1150,57.30434782608695
18097340109,"Census Tract 3401.09, Marion County, Indiana",2017,498,291,207,58.433734939759034,41.566265060240966,74,207,35.7487922705314
18097340110,"Census Tract 3401.10, Marion County, Indiana",2017,2258,452,1806,20.017714791851194,79.98228520814881,947,1806,52.436323366555925
18097340111,"Census Tract 3401.11, Marion County, Indiana",2017,987,822,165,83.28267477203647,16.717325227963524,50,165,30.303030303030305
18097340112,"Census Tract 3401.12, Marion County, Indiana",2017,2498,1008,1490,40.352281825460366,59.647718174539634,628,1490,42.147651006711406
18097340113,"Census Tract 3401.13, Marion County, Indiana",2017,1612,1059,553,65.69478908188586,34.30521091811414,437,553,79.02350813743219
18097340114,"Census Tract 3401.14, Marion County, Indiana",2017,1513,1294,219,85.52544613350959,14.474553866490416,114,219,52.054794520547944
18097340201,"Census Tract 3402.01, Marion County, Indiana",2017,1057,683,374,64.61684011352885,35.38315988647115,129,374,34.49197860962567
18097340202,"Census Tract 3402.02, Marion County, Indiana",2017,1711,597,1114,34.89187609585038,65.10812390414962,579,1114,51.974865350089765
18097340901,"Census Tract 3409.01, Marion County, Indiana",2017,1323,1129,194,85.3363567649282,14.663643235071806,60,194,30.927835051546392
18097340902,"Census Tract 3409.02, Marion County, Indiana",2017,2790,648,2142,23.225806451612904,76.7741935483871,993,2142,46.358543417366946
18097341903,"Census Tract 3419.03, Marion County, Indiana",2017,1994,335,1659,16.800401203610832,83.19959879638917,872,1659,52.561784207353824
18097341904,"Census Tract 3419.04, Marion County, Indiana",2017,898,243,655,27.06013363028953,72.93986636971047,367,655,56.030534351145036
18097370301,"Census Tract 3703.01, Marion County, Indiana",2017,3258,2733,525,83.88581952117863,16.114180478821364,179,525,34.095238095238095
18097370302,"Census Tract 3703.02, Marion County, Indiana",2017,2930,2412,518,82.32081911262799,17.679180887372013,292,518,56.37065637065637
18097380403,"Census Tract 3804.03, Marion County, Indiana",2017,1518,988,530,65.08563899868248,34.91436100131752,208,530,39.24528301886792
18097380404,"Census Tract 3804.04, Marion County, Indiana",2017,1632,1075,557,65.87009803921569,34.129901960784316,323,557,57.98922800718133
18097390101,"Census Tract 3901.01, Marion County, Indiana",2017,2857,2417,440,84.59922996149807,15.400770038501925,157,440,35.68181818181818
18097390102,"Census Tract 3901.02, Marion County, Indiana",2017,2076,904,1172,43.54527938342967,56.45472061657033,728,1172,62.1160409556314
18097390404,"Census Tract 3904.04, Marion County, Indiana",2017,2163,1523,640,70.41146555709662,29.588534442903374,298,640,46.5625
18097390405,"Census Tract 3904.05, Marion County, Indiana",2017,1728,630,1098,36.458333333333336,63.541666666666664,366,1098,33.333333333333336
18097390500,"Census Tract 3905, Marion County, Indiana",2017,910,493,417,54.175824175824175,45.824175824175825,205,417,49.16067146282974
18097390600,"Census Tract 3906, Marion County, Indiana",2017,2565,505,2060,19.68810916179337,80.31189083820662,1097,2060,53.25242718446602
18097390700,"Census Tract 3907, Marion County, Indiana",2017,877,375,502,42.7594070695553,57.2405929304447,339,502,67.52988047808765
18097390800,"Census Tract 3908, Marion County, Indiana",2017,1360,876,484,64.41176470588235,35.588235294117645,188,484,38.84297520661157
18097390900,"Census Tract 3909, Marion County, Indiana",2017,1291,560,731,43.37722695584818,56.62277304415182,296,731,40.49247606019152
18097391000,"Census Tract 3910, Marion County, Indiana",2017,3039,353,2686,11.615663047054952,88.38433695294505,1275,2686,47.46835443037975
18097380200,"Census Tract 3802, Marion County, Indiana",2017,1368,660,708,48.24561403508772,51.75438596491228,332,708,46.89265536723164
18097380902,"Census Tract 3809.02, Marion County, Indiana",2017,2453,1871,582,76.27395026498165,23.726049735018346,196,582,33.67697594501718
18097381203,"Census Tract 3812.03, Marion County, Indiana",2017,1064,249,815,23.402255639097746,76.59774436090225,430,815,52.760736196319016
18097360202,"Census Tract 3602.02, Marion County, Indiana",2017,1198,791,407,66.02671118530886,33.97328881469115,332,407,81.57248157248158
18097360301,"Census Tract 3603.01, Marion County, Indiana",2017,1336,634,702,47.455089820359284,52.544910179640716,339,702,48.29059829059829
18097360401,"Census Tract 3604.01, Marion County, Indiana",2017,2282,692,1590,30.32427695004382,69.67572304995618,935,1590,58.80503144654088
18097380501,"Census Tract 3805.01, Marion County, Indiana",2017,1004,670,334,66.73306772908367,33.266932270916335,182,334,54.49101796407186
18097390402,"Census Tract 3904.02, Marion County, Indiana",2017,4068,3309,759,81.34218289085545,18.657817109144542,238,759,31.357048748353098
18097321300,"Census Tract 3213, Marion County, Indiana",2017,1253,707,546,56.42458100558659,43.57541899441341,187,546,34.24908424908425
18097330103,"Census Tract 3301.03, Marion County, Indiana",2017,2642,1472,1170,55.715367146101435,44.284632853898565,545,1170,46.58119658119658
18097330600,"Census Tract 3306, Marion County, Indiana",2017,1998,1113,885,55.705705705705704,44.294294294294296,493,885,55.706214689265536
18097322600,"Census Tract 3226, Marion County, Indiana",2017,1885,313,1572,16.604774535809018,83.39522546419099,813,1572,51.717557251908396
18097321100,"Census Tract 3211, Marion County, Indiana",2017,1515,1039,476,68.58085808580859,31.419141914191417,153,476,32.142857142857146
18097320400,"Census Tract 3204, Marion County, Indiana",2017,1419,662,757,46.65257223396758,53.34742776603242,329,757,43.46103038309115
18097340800,"Census Tract 3408, Marion County, Indiana",2017,653,527,126,80.70444104134762,19.295558958652375,69,126,54.76190476190476
18097354700,"Census Tract 3547, Marion County, Indiana",2017,544,218,326,40.0735294117647,59.9264705882353,221,326,67.79141104294479
18097355700,"Census Tract 3557, Marion County, Indiana",2017,919,340,579,36.996735582154514,63.003264417845486,329,579,56.82210708117444
18097357400,"Census Tract 3574, Marion County, Indiana",2017,1575,726,849,46.095238095238095,53.904761904761905,430,849,50.647820965842165
18097357800,"Census Tract 3578, Marion County, Indiana",2017,711,366,345,51.47679324894515,48.52320675105485,176,345,51.01449275362319
18097358100,"Census Tract 3581, Marion County, Indiana",2017,1036,455,581,43.91891891891892,56.08108108108108,337,581,58.003442340791736
18097360404,"Census Tract 3604.04, Marion County, Indiana",2017,2856,1007,1849,35.25910364145658,64.74089635854342,1145,1849,61.92536506219578
18097380502,"Census Tract 3805.02, Marion County, Indiana",2017,1477,494,983,33.446174678402166,66.55382532159783,460,983,46.79552390640895
18097380800,"Census Tract 3808, Marion County, Indiana",2017,1080,862,218,79.81481481481481,20.185185185185187,94,218,43.11926605504587
18097380901,"Census Tract 3809.01, Marion County, Indiana",2017,1845,1616,229,87.58807588075881,12.411924119241192,83,229,36.24454148471616
18097381101,"Census Tract 3811.01, Marion County, Indiana",2017,2489,1504,985,60.42587384491764,39.57412615508236,542,985,55.025380710659896
18097381102,"Census Tract 3811.02, Marion County, Indiana",2017,2523,1831,692,72.57233452239397,27.427665477606023,504,692,72.83236994219654
18097381204,"Census Tract 3812.04, Marion County, Indiana",2017,1507,207,1300,13.735899137358992,86.26410086264102,718,1300,55.23076923076923
18097390300,"Census Tract 3903, Marion County, Indiana",2017,1884,1723,161,91.4543524416136,8.545647558386412,48,161,29.81366459627329
18097310106,"Census Tract 3101.06, Marion County, Indiana",2017,2087,209,1878,10.014374700527073,89.98562529947293,889,1878,47.33759318423855
18097320108,"Census Tract 3201.08, Marion County, Indiana",2017,2229,256,1973,11.48497083894123,88.51502916105878,1004,1973,50.88697415103903
18097320202,"Census Tract 3202.02, Marion County, Indiana",2017,1906,1269,637,66.57922350472194,33.42077649527807,141,637,22.135007849293565
18097320301,"Census Tract 3203.01, Marion County, Indiana",2017,1875,1313,562,70.02666666666667,29.973333333333333,124,562,22.06405693950178
18097320700,"Census Tract 3207, Marion County, Indiana",2017,1015,622,393,61.2807881773399,38.7192118226601,124,393,31.552162849872772
18097321002,"Census Tract 3210.02, Marion County, Indiana",2017,1824,1353,471,74.17763157894737,25.82236842105263,178,471,37.79193205944798
18097380600,"Census Tract 3806, Marion County, Indiana",2017,2124,1044,1080,49.152542372881356,50.847457627118644,623,1080,57.68518518518518
18097321800,"Census Tract 3218, Marion County, Indiana",2017,1648,1096,552,66.50485436893204,33.49514563106796,154,552,27.89855072463768
18097322200,"Census Tract 3222, Marion County, Indiana",2017,792,577,215,72.85353535353535,27.146464646464647,65,215,30.232558139534884
18097330203,"Census Tract 3302.03, Marion County, Indiana",2017,2140,2094,46,97.85046728971963,2.149532710280374,0,46,0
18097341902,"Census Tract 3419.02, Marion County, Indiana",2017,1465,1168,297,79.72696245733789,20.273037542662117,154,297,51.851851851851855
18097330204,"Census Tract 3302.04, Marion County, Indiana",2017,2154,1905,249,88.44011142061281,11.559888579387186,11,249,4.417670682730924
18097330500,"Census Tract 3305, Marion County, Indiana",2017,2598,1443,1155,55.54272517321016,44.45727482678984,634,1155,54.891774891774894
18097352300,"Census Tract 3523, Marion County, Indiana",2017,529,249,280,47.06994328922495,52.93005671077505,147,280,52.5
18097355100,"Census Tract 3551, Marion County, Indiana",2017,703,180,523,25.604551920341393,74.3954480796586,254,523,48.565965583174
18097355300,"Census Tract 3553, Marion County, Indiana",2017,1069,545,524,50.9822263797942,49.0177736202058,273,524,52.099236641221374
18097320109,"Census Tract 3201.09, Marion County, Indiana",2017,1192,927,265,77.76845637583892,22.231543624161073,64,265,24.150943396226417
18097310104,"Census Tract 3101.04, Marion County, Indiana",2017,1906,963,943,50.524658971668416,49.475341028331584,398,943,42.20572640509014
18097310308,"Census Tract 3103.08, Marion County, Indiana",2017,1158,709,449,61.226252158894646,38.773747841105354,264,449,58.797327394209354
18097320107,"Census Tract 3201.07, Marion County, Indiana",2017,796,647,149,81.28140703517587,18.718592964824122,37,149,24.83221476510067
18097320800,"Census Tract 3208, Marion County, Indiana",2017,1167,1083,84,92.80205655526993,7.197943444730077,32,84,38.095238095238095
18097321200,"Census Tract 3212, Marion County, Indiana",2017,2105,1757,348,83.46793349168647,16.53206650831354,61,348,17.528735632183906
18097330401,"Census Tract 3304.01, Marion County, Indiana",2017,2268,1659,609,73.14814814814815,26.85185185185185,283,609,46.4696223316913
18097330900,"Census Tract 3309, Marion County, Indiana",2017,2156,570,1586,26.437847866419293,73.56215213358071,762,1586,48.0453972257251
18097340101,"Census Tract 3401.01, Marion County, Indiana",2017,1383,1070,313,77.36804049168474,22.631959508315255,171,313,54.63258785942492
18097340600,"Census Tract 3406, Marion County, Indiana",2017,1847,869,978,47.049269085002706,52.950730914997294,619,978,63.29243353783231
18097341100,"Census Tract 3411, Marion County, Indiana",2017,753,373,380,49.53519256308101,50.46480743691899,244,380,64.21052631578948
18097342000,"Census Tract 3420, Marion County, Indiana",2017,2155,1960,195,90.95127610208817,9.048723897911833,45,195,23.076923076923077
18097350800,"Census Tract 3508, Marion County, Indiana",2017,831,234,597,28.15884476534296,71.84115523465704,380,597,63.651591289782246
18097351200,"Census Tract 3512, Marion County, Indiana",2017,874,332,542,37.986270022883296,62.013729977116704,379,542,69.92619926199262
18097352100,"Census Tract 3521, Marion County, Indiana",2017,755,313,442,41.45695364238411,58.54304635761589,285,442,64.47963800904978
18097356200,"Census Tract 3562, Marion County, Indiana",2017,907,345,562,38.03748621830209,61.96251378169791,212,562,37.72241992882562
18097357900,"Census Tract 3579, Marion County, Indiana",2017,1556,969,587,62.275064267352185,37.724935732647815,317,587,54.003407155025556
18097360101,"Census Tract 3601.01, Marion County, Indiana",2017,896,279,617,31.138392857142858,68.86160714285714,390,617,63.20907617504052
18097360402,"Census Tract 3604.02, Marion County, Indiana",2017,655,335,320,51.14503816793893,48.85496183206107,184,320,57.5
18097360700,"Census Tract 3607, Marion County, Indiana",2017,863,710,153,82.27114716106605,17.72885283893395,64,153,41.830065359477125
18097351500,"Census Tract 3515, Marion County, Indiana",2017,745,179,566,24.026845637583893,75.97315436241611,291,566,51.41342756183746
18097320903,"Census Tract 3209.03, Marion County, Indiana",2017,1674,544,1130,32.49701314217443,67.50298685782556,588,1130,52.0353982300885
18097360601,"Census Tract 3606.01, Marion County, Indiana",2017,1934,1486,448,76.83557394002068,23.164426059979316,176,448,39.285714285714285
18097320106,"Census Tract 3201.06, Marion County, Indiana",2017,926,636,290,68.68250539956803,31.317494600431967,119,290,41.03448275862069
18097322500,"Census Tract 3225, Marion County, Indiana",2017,714,155,559,21.708683473389357,78.29131652661064,257,559,45.974955277280856
18097342200,"Census Tract 3422, Marion County, Indiana",2017,1933,889,1044,45.99068804966374,54.00931195033626,543,1044,52.01149425287356
18097355600,"Census Tract 3556, Marion County, Indiana",2017,816,378,438,46.3235294117647,53.6764705882353,251,438,57.305936073059364
18097310305,"Census Tract 3103.05, Marion County, Indiana",2017,2454,843,1611,34.3520782396088,65.6479217603912,697,1611,43.265052762259465
18097322100,"Census Tract 3221, Marion County, Indiana",2017,1019,576,443,56.52600588812561,43.47399411187439,220,443,49.66139954853273
18097342300,"Census Tract 3423, Marion County, Indiana",2017,2389,1380,1009,57.76475512766848,42.23524487233152,532,1009,52.72547076313182
18097353300,"Census Tract 3533, Marion County, Indiana",2017,1571,188,1383,11.966900063653723,88.03309993634628,473,1383,34.201012292118584
18097357100,"Census Tract 3571, Marion County, Indiana",2017,838,429,409,51.19331742243437,48.80668257756563,233,409,56.9682151589242
18097360602,"Census Tract 3606.02, Marion County, Indiana",2017,2409,1127,1282,46.782897467828974,53.217102532171026,839,1282,65.44461778471138
18097361100,"Census Tract 3611, Marion County, Indiana",2017,1565,770,795,49.201277955271564,50.798722044728436,344,795,43.270440251572325
18097370201,"Census Tract 3702.01, Marion County, Indiana",2017,1501,709,792,47.23517654896735,52.76482345103265,319,792,40.27777777777778
18097381002,"Census Tract 3810.02, Marion County, Indiana",2017,1107,949,158,85.72719060523939,14.272809394760614,55,158,34.81012658227848
18097390200,"Census Tract 3902, Marion County, Indiana",2017,1203,915,288,76.05985037406484,23.940149625935163,196,288,68.05555555555556
18097390403,"Census Tract 3904.03, Marion County, Indiana",2017,3295,3043,252,92.35204855842186,7.647951441578149,80,252,31.746031746031747
18097310103,"Census Tract 3101.03, Marion County, Indiana",2017,2525,2199,326,87.08910891089108,12.910891089108912,123,326,37.73006134969325
18097310105,"Census Tract 3101.05, Marion County, Indiana",2017,1589,924,665,58.14977973568282,41.85022026431718,310,665,46.61654135338346
18097310108,"Census Tract 3101.08, Marion County, Indiana",2017,1475,1247,228,84.54237288135593,15.457627118644067,115,228,50.43859649122807
18097320203,"Census Tract 3202.03, Marion County, Indiana",2017,1731,310,1421,17.908723281340265,82.09127671865973,612,1421,43.06826178747361
18097320500,"Census Tract 3205, Marion County, Indiana",2017,1447,820,627,56.66897028334485,43.33102971665515,211,627,33.65231259968102
18097320901,"Census Tract 3209.01, Marion County, Indiana",2017,2536,1806,730,71.21451104100946,28.785488958990538,400,730,54.794520547945204
18097322400,"Census Tract 3224, Marion County, Indiana",2017,1417,625,792,44.10726887791108,55.89273112208892,306,792,38.63636363636363
18097330106,"Census Tract 3301.06, Marion County, Indiana",2017,2493,347,2146,13.918973124749298,86.0810268752507,1095,2146,51.02516309412861
18097330107,"Census Tract 3301.07, Marion County, Indiana",2017,2521,2472,49,98.05632685442285,1.9436731455771519,0,49,0
18097320105,"Census Tract 3201.05, Marion County, Indiana",2017,1806,901,905,49.88925802879291,50.11074197120709,437,905,48.28729281767956
18097320204,"Census Tract 3202.04, Marion County, Indiana",2017,2600,518,2082,19.923076923076923,80.07692307692308,962,2082,46.20557156580211
18097320600,"Census Tract 3206, Marion County, Indiana",2017,1130,804,326,71.15044247787611,28.849557522123895,129,326,39.57055214723926
18097321700,"Census Tract 3217, Marion County, Indiana",2017,2032,1306,726,64.27165354330708,35.72834645669291,244,726,33.608815426997246
18097330202,"Census Tract 3302.02, Marion County, Indiana",2017,4124,2372,1752,57.516973811833175,42.483026188166825,951,1752,54.28082191780822
18097340300,"Census Tract 3403, Marion County, Indiana",2017,2541,905,1636,35.61589925226289,64.38410074773711,932,1636,56.9682151589242
18097341200,"Census Tract 3412, Marion County, Indiana",2017,800,299,501,37.375,62.625,283,501,56.48702594810379
18097341600,"Census Tract 3416, Marion County, Indiana",2017,819,265,554,32.356532356532355,67.64346764346764,281,554,50.72202166064982
18097342101,"Census Tract 3421.01, Marion County, Indiana",2017,1826,1300,526,71.19386637458926,28.806133625410734,382,526,72.6235741444867
18097342600,"Census Tract 3426, Marion County, Indiana",2017,1110,562,548,50.630630630630634,49.369369369369366,357,548,65.14598540145985
18097352400,"Census Tract 3524, Marion County, Indiana",2017,1332,449,883,33.708708708708706,66.29129129129129,590,883,66.8176670441676
18097352700,"Census Tract 3527, Marion County, Indiana",2017,1091,415,676,38.03849679193401,61.96150320806599,222,676,32.84023668639053
18097330700,"Census Tract 3307, Marion County, Indiana",2017,2517,1560,957,61.97854588796186,38.02145411203814,170,957,17.763845350052247
18097350100,"Census Tract 3501, Marion County, Indiana",2017,572,287,285,50.17482517482517,49.82517482517483,174,285,61.05263157894737
18097360900,"Census Tract 3609, Marion County, Indiana",2017,2397,1472,925,61.410095953274926,38.589904046725074,643,925,69.51351351351352
18097361000,"Census Tract 3610, Marion County, Indiana",2017,947,774,173,81.73178458289335,18.268215417106653,67,173,38.72832369942196
18097340400,"Census Tract 3404, Marion County, Indiana",2017,1197,544,653,45.4469507101086,54.5530492898914,356,653,54.51761102603369
18097342400,"Census Tract 3424, Marion County, Indiana",2017,636,309,327,48.58490566037736,51.41509433962264,144,327,44.03669724770642
18097342500,"Census Tract 3425, Marion County, Indiana",2017,1650,1082,568,65.57575757575758,34.42424242424242,413,568,72.71126760563381
18097350500,"Census Tract 3505, Marion County, Indiana",2017,881,387,494,43.927355278093074,56.072644721906926,245,494,49.59514170040486
18097350600,"Census Tract 3506, Marion County, Indiana",2017,1754,971,783,55.359179019384264,44.640820980615736,551,783,70.37037037037037
18097351600,"Census Tract 3516, Marion County, Indiana",2017,1015,529,486,52.118226600985224,47.881773399014776,159,486,32.71604938271605
18097351000,"Census Tract 3510, Marion County, Indiana",2017,1022,413,609,40.41095890410959,59.58904109589041,369,609,60.59113300492611
18097352500,"Census Tract 3525, Marion County, Indiana",2017,1470,875,595,59.523809523809526,40.476190476190474,345,595,57.983193277310924
18097352800,"Census Tract 3528, Marion County, Indiana",2017,445,160,285,35.95505617977528,64.04494382022472,176,285,61.75438596491228
18097353600,"Census Tract 3536, Marion County, Indiana",2017,836,303,533,36.24401913875598,63.75598086124402,366,533,68.66791744840525
18097354900,"Census Tract 3549, Marion County, Indiana",2017,1071,406,665,37.908496732026144,62.091503267973856,368,665,55.338345864661655
18097355900,"Census Tract 3559, Marion County, Indiana",2017,887,442,445,49.83089064261556,50.16910935738444,229,445,51.46067415730337
18097357000,"Census Tract 3570, Marion County, Indiana",2017,848,410,438,48.34905660377358,51.65094339622642,272,438,62.10045662100457
18097360102,"Census Tract 3601.02, Marion County, Indiana",2017,1026,425,601,41.42300194931774,58.57699805068226,349,601,58.069883527454245
18097380700,"Census Tract 3807, Marion County, Indiana",2017,2185,1023,1162,46.81922196796339,53.18077803203661,723,1162,62.22030981067125
18097361400,"Census Tract 3614, Marion County, Indiana",2017,4216,2949,1267,69.94781783681215,30.052182163187855,384,1267,30.307813733228098
18097361600,"Census Tract 3616, Marion County, Indiana",2017,3005,2896,109,96.37271214642263,3.627287853577371,69,109,63.30275229357798
18097310201,"Census Tract 3102.01, Marion County, Indiana",2017,1276,744,532,58.307210031347964,41.692789968652036,411,532,77.25563909774436
18097310306,"Census Tract 3103.06, Marion County, Indiana",2017,2134,470,1664,22.02436738519213,77.97563261480788,886,1664,53.24519230769231
18097320304,"Census Tract 3203.04, Marion County, Indiana",2017,3044,1890,1154,62.089356110381075,37.910643889618925,400,1154,34.66204506065858
18097321001,"Census Tract 3210.01, Marion County, Indiana",2017,995,756,239,75.97989949748744,24.020100502512562,117,239,48.95397489539749
18097356400,"Census Tract 3564, Marion County, Indiana",2017,1500,536,964,35.733333333333334,64.26666666666667,477,964,49.481327800829874
18097354400,"Census Tract 3544, Marion County, Indiana",2017,694,362,332,52.16138328530259,47.83861671469741,152,332,45.78313253012048
18097331000,"Census Tract 3310, Marion County, Indiana",2017,1572,1037,535,65.96692111959288,34.033078880407125,275,535,51.401869158878505
18097340500,"Census Tract 3405, Marion County, Indiana",2017,1722,496,1226,28.80371660859466,71.19628339140534,570,1226,46.492659053833606
18097340700,"Census Tract 3407, Marion County, Indiana",2017,1224,547,677,44.689542483660134,55.310457516339866,342,677,50.51698670605613
18097341700,"Census Tract 3417, Marion County, Indiana",2017,1716,799,917,46.561771561771565,53.438228438228435,587,917,64.01308615049074
18097350300,"Census Tract 3503, Marion County, Indiana",2017,1295,142,1153,10.965250965250965,89.03474903474904,654,1153,56.721595836947095
18097351900,"Census Tract 3519, Marion County, Indiana",2017,1059,542,517,51.18035882908404,48.81964117091596,201,517,38.87814313346228
18097355400,"Census Tract 3554, Marion County, Indiana",2017,1343,415,928,30.90096798212956,69.09903201787044,439,928,47.30603448275862
18097355500,"Census Tract 3555, Marion County, Indiana",2017,1440,805,635,55.90277777777778,44.09722222222222,225,635,35.43307086614173
18097356900,"Census Tract 3569, Marion County, Indiana",2017,919,385,534,41.89336235038085,58.10663764961915,310,534,58.052434456928836
18097357200,"Census Tract 3572, Marion County, Indiana",2017,931,426,505,45.757250268528466,54.242749731471534,313,505,61.98019801980198
18097358000,"Census Tract 3580, Marion County, Indiana",2017,495,287,208,57.97979797979798,42.02020202020202,78,208,37.5
18097370202,"Census Tract 3702.02, Marion County, Indiana",2017,2504,1234,1270,49.281150159744406,50.718849840255594,752,1270,59.21259842519685
18097360302,"Census Tract 3603.02, Marion County, Indiana",2017,900,240,660,26.666666666666668,73.33333333333333,389,660,58.93939393939394
18097361200,"Census Tract 3612, Marion County, Indiana",2017,1399,735,664,52.53752680486061,47.46247319513939,369,664,55.5722891566265
18097361300,"Census Tract 3613, Marion County, Indiana",2017,981,729,252,74.31192660550458,25.68807339449541,104,252,41.26984126984127
18097380402,"Census Tract 3804.02, Marion County, Indiana",2017,1948,502,1446,25.770020533880903,74.22997946611909,764,1446,52.83540802213001
18097360201,"Census Tract 3602.01, Marion County, Indiana",2017,1566,685,881,43.74201787994892,56.25798212005108,392,881,44.49489216799092
18097360501,"Census Tract 3605.01, Marion County, Indiana",2017,2341,1460,881,62.36651003844511,37.63348996155489,389,881,44.154370034052214
18097320303,"Census Tract 3203.03, Marion County, Indiana",2017,1841,6,1835,0.32590983161325365,99.67409016838674,572,1835,31.1716621253406
18097320902,"Census Tract 3209.02, Marion County, Indiana",2017,1611,512,1099,31.781502172563624,68.21849782743638,739,1099,67.24294813466788
18097321600,"Census Tract 3216, Marion County, Indiana",2017,2389,1126,1263,47.1326915027208,52.8673084972792,679,1263,53.76088677751385
18097321900,"Census Tract 3219, Marion County, Indiana",2017,1255,942,313,75.0597609561753,24.9402390438247,121,313,38.65814696485623
18097322000,"Census Tract 3220, Marion County, Indiana",2017,1391,756,635,54.34938892882818,45.65061107117182,239,635,37.63779527559055
18097322700,"Census Tract 3227, Marion County, Indiana",2017,813,608,205,74.78474784747847,25.215252152521526,138,205,67.3170731707317
18097340102,"Census Tract 3401.02, Marion County, Indiana",2017,1617,358,1259,22.139764996907854,77.86023500309214,789,1259,62.66878474980143
18097341000,"Census Tract 3410, Marion County, Indiana",2017,744,580,164,77.95698924731182,22.043010752688172,68,164,41.46341463414634
18097381205,"Census Tract 3812.05, Marion County, Indiana",2018,2594,1095,1499,42.21279876638396,57.78720123361604,587,1499,39.15943962641761
18097321400,"Census Tract 3214, Marion County, Indiana",2018,2480,1540,940,62.096774193548384,37.903225806451616,393,940,41.808510638297875
18097322300,"Census Tract 3223, Marion County, Indiana",2018,1052,781,271,74.23954372623574,25.76045627376426,79,271,29.15129151291513
18097330105,"Census Tract 3301.05, Marion County, Indiana",2018,2680,670,2010,25,75,564,2010,28.059701492537314
18097340108,"Census Tract 3401.08, Marion County, Indiana",2018,857,140,717,16.33605600933489,83.66394399066512,361,717,50.348675034867505
18097350400,"Census Tract 3504, Marion County, Indiana",2018,994,557,437,56.03621730382294,43.96378269617706,263,437,60.183066361556065
18097350700,"Census Tract 3507, Marion County, Indiana",2018,598,393,205,65.7190635451505,34.280936454849495,138,205,67.3170731707317
18097350900,"Census Tract 3509, Marion County, Indiana",2018,564,291,273,51.59574468085106,48.40425531914894,150,273,54.94505494505494
18097351700,"Census Tract 3517, Marion County, Indiana",2018,940,502,438,53.40425531914894,46.59574468085106,221,438,50.45662100456621
18097310110,"Census Tract 3101.10, Marion County, Indiana",2018,1374,586,788,42.64919941775837,57.35080058224163,358,788,45.431472081218274
18097310111,"Census Tract 3101.11, Marion County, Indiana",2018,1775,719,1056,40.50704225352113,59.49295774647887,511,1056,48.390151515151516
18097310204,"Census Tract 3102.04, Marion County, Indiana",2018,1790,972,818,54.30167597765363,45.69832402234637,394,818,48.16625916870416
18097310310,"Census Tract 3103.10, Marion County, Indiana",2018,1572,1180,392,75.06361323155217,24.936386768447836,210,392,53.57142857142857
18097310203,"Census Tract 3102.03, Marion County, Indiana",2018,2250,1322,928,58.75555555555555,41.24444444444445,470,928,50.64655172413793
18097310309,"Census Tract 3103.09, Marion County, Indiana",2018,1566,362,1204,23.116219667943806,76.88378033205619,615,1204,51.079734219269106
18097310311,"Census Tract 3103.11, Marion County, Indiana",2018,1849,1711,138,92.53650621957814,7.4634937804218495,86,138,62.31884057971015
18097310312,"Census Tract 3103.12, Marion County, Indiana",2018,2462,1002,1460,40.69861900893582,59.30138099106418,748,1460,51.23287671232877
18097330108,"Census Tract 3301.08, Marion County, Indiana",2018,1489,1416,73,95.09738079247818,4.902619207521827,5,73,6.8493150684931505
18097330109,"Census Tract 3301.09, Marion County, Indiana",2018,2218,2049,169,92.380522993688,7.6194770063119925,39,169,23.076923076923077
18097340300,"Census Tract 3403, Marion County, Indiana",2018,2696,921,1775,34.16172106824926,65.83827893175074,1079,1775,60.7887323943662
18097341200,"Census Tract 3412, Marion County, Indiana",2018,824,346,478,41.99029126213592,58.00970873786408,276,478,57.74058577405858
18097341600,"Census Tract 3416, Marion County, Indiana",2018,825,327,498,39.63636363636363,60.36363636363637,231,498,46.3855421686747
18097342101,"Census Tract 3421.01, Marion County, Indiana",2018,1781,1245,536,69.90454800673778,30.095451993262213,390,536,72.76119402985074
18097352600,"Census Tract 3526, Marion County, Indiana",2018,1307,547,760,41.851568477429225,58.148431522570775,392,760,51.578947368421055
18097353500,"Census Tract 3535, Marion County, Indiana",2018,1069,168,901,15.715622076707202,84.2843779232928,406,901,45.061043285238625
18097354800,"Census Tract 3548, Marion County, Indiana",2018,564,231,333,40.95744680851064,59.04255319148936,225,333,67.56756756756756
18097355000,"Census Tract 3550, Marion County, Indiana",2018,819,303,516,36.99633699633699,63.00366300366301,279,516,54.06976744186046
18097357500,"Census Tract 3575, Marion County, Indiana",2018,1469,1135,334,77.26344452008169,22.736555479918312,169,334,50.59880239520958
18097357600,"Census Tract 3576, Marion County, Indiana",2018,2312,1085,1227,46.92906574394463,53.07093425605537,737,1227,60.06519967400163
18097360202,"Census Tract 3602.02, Marion County, Indiana",2018,1228,819,409,66.69381107491857,33.306188925081436,293,409,71.63814180929096
18097354200,"Census Tract 3542, Marion County, Indiana",2018,4207,1306,2901,31.043498930354172,68.95650106964582,1106,2901,38.124784557049296
18097354500,"Census Tract 3545, Marion County, Indiana",2018,1028,387,641,37.64591439688716,62.35408560311284,330,641,51.482059282371296
18097357300,"Census Tract 3573, Marion County, Indiana",2018,894,308,586,34.45190156599553,65.54809843400447,387,586,66.04095563139931
18097360405,"Census Tract 3604.05, Marion County, Indiana",2018,2369,1498,871,63.23343182777543,36.76656817222457,401,871,46.0390355912744
18097360502,"Census Tract 3605.02, Marion County, Indiana",2018,2428,1443,985,59.43163097199341,40.56836902800659,617,985,62.63959390862944
18097360800,"Census Tract 3608, Marion County, Indiana",2018,1289,354,935,27.463149728471684,72.53685027152832,548,935,58.6096256684492
18097380200,"Census Tract 3802, Marion County, Indiana",2018,1384,664,720,47.97687861271676,52.02312138728324,391,720,54.30555555555556
18097380902,"Census Tract 3809.02, Marion County, Indiana",2018,2421,1798,623,74.26683188764973,25.733168112350267,227,623,36.43659711075441
18097381203,"Census Tract 3812.03, Marion County, Indiana",2018,1073,207,866,19.29170549860205,80.70829450139794,458,866,52.88683602771363
18097320109,"Census Tract 3201.09, Marion County, Indiana",2018,1195,963,232,80.5857740585774,19.414225941422593,59,232,25.43103448275862
18097310104,"Census Tract 3101.04, Marion County, Indiana",2018,1876,1046,830,55.75692963752665,44.24307036247335,278,830,33.493975903614455
18097310308,"Census Tract 3103.08, Marion County, Indiana",2018,1120,735,385,65.625,34.375,215,385,55.84415584415584
18097320107,"Census Tract 3201.07, Marion County, Indiana",2018,803,662,141,82.44084682440847,17.559153175591533,42,141,29.78723404255319
18097320800,"Census Tract 3208, Marion County, Indiana",2018,1198,1117,81,93.23873121869784,6.76126878130217,28,81,34.5679012345679
18097310306,"Census Tract 3103.06, Marion County, Indiana",2018,2139,517,1622,24.170172978027114,75.82982702197289,764,1622,47.10234278668311
18097320304,"Census Tract 3203.04, Marion County, Indiana",2018,3099,1928,1171,62.213617295901905,37.786382704098095,468,1171,39.96584116140051
18097321001,"Census Tract 3210.01, Marion County, Indiana",2018,1016,769,247,75.68897637795276,24.311023622047244,99,247,40.08097165991903
18097356400,"Census Tract 3564, Marion County, Indiana",2018,1336,462,874,34.58083832335329,65.41916167664671,447,874,51.1441647597254
18097354400,"Census Tract 3544, Marion County, Indiana",2018,667,370,297,55.472263868065966,44.527736131934034,145,297,48.821548821548824
18097331000,"Census Tract 3310, Marion County, Indiana",2018,1609,1023,586,63.57986326911125,36.42013673088875,285,586,48.63481228668942
18097340500,"Census Tract 3405, Marion County, Indiana",2018,1625,461,1164,28.369230769230768,71.63076923076923,536,1164,46.04810996563574
18097330206,"Census Tract 3302.06, Marion County, Indiana",2018,1749,1589,160,90.85191538021726,9.148084619782733,98,160,61.25
18097330209,"Census Tract 3302.09, Marion County, Indiana",2018,3271,2622,649,80.15897279119535,19.841027208804647,334,649,51.463790446841294
18097330208,"Census Tract 3302.08, Marion County, Indiana",2018,1220,1135,85,93.0327868852459,6.967213114754099,21,85,24.705882352941178
18097330803,"Census Tract 3308.03, Marion County, Indiana",2018,1234,404,830,32.73905996758509,67.26094003241491,435,830,52.40963855421687
18097330804,"Census Tract 3308.04, Marion County, Indiana",2018,1190,209,981,17.563025210084035,82.43697478991596,402,981,40.97859327217125
18097330805,"Census Tract 3308.05, Marion County, Indiana",2018,1318,278,1040,21.09256449165402,78.90743550834598,461,1040,44.32692307692308
18097330806,"Census Tract 3308.06, Marion County, Indiana",2018,1543,459,1084,29.747245625405053,70.25275437459494,604,1084,55.71955719557196
18097340109,"Census Tract 3401.09, Marion County, Indiana",2018,461,277,184,60.08676789587852,39.91323210412148,76,184,41.30434782608695
18097340110,"Census Tract 3401.10, Marion County, Indiana",2018,2175,449,1726,20.64367816091954,79.356321839080465,925,1726,53.592120509849366
18097342600,"Census Tract 3426, Marion County, Indiana",2018,1113,449,664,40.34141958670261,59.65858041329739,420,664,63.25301204819277
18097340700,"Census Tract 3407, Marion County, Indiana",2018,1231,572,659,46.46628757108042,53.53371242891958,296,659,44.916540212443095
18097341700,"Census Tract 3417, Marion County, Indiana",2018,1668,725,943,43.465227817745806,56.534772182254194,619,943,65.64156945917286
18097350300,"Census Tract 3503, Marion County, Indiana",2018,1399,140,1259,10.007147962830594,89.99285203716941,706,1259,56.07625099285147
18097351900,"Census Tract 3519, Marion County, Indiana",2018,1039,482,557,46.390760346487006,53.609239653512994,227,557,40.754039497307005
18097355400,"Census Tract 3554, Marion County, Indiana",2018,1296,521,775,40.20061728395062,59.79938271604938,309,775,39.87096774193548
18097355500,"Census Tract 3555, Marion County, Indiana",2018,1451,836,615,57.615437629221226,42.384562370778774,168,615,27.317073170731707
18097356900,"Census Tract 3569, Marion County, Indiana",2018,849,371,478,43.69846878680801,56.30153121319199,284,478,59.41422594142259
18097357200,"Census Tract 3572, Marion County, Indiana",2018,906,446,460,49.22737306843267,50.77262693156733,232,460,50.43478260869565
18097358000,"Census Tract 3580, Marion County, Indiana",2018,483,259,224,53.6231884057971,46.3768115942029,123,224,54.910714285714285
18097370202,"Census Tract 3702.02, Marion County, Indiana",2018,2548,1239,1309,48.62637362637363,51.37362637362637,716,1309,54.69824293353705
18097360302,"Census Tract 3603.02, Marion County, Indiana",2018,882,241,641,27.324263038548754,72.67573696145125,361,641,56.3182527301092
18097361200,"Census Tract 3612, Marion County, Indiana",2018,1426,719,707,50.420757363253855,49.579242636746145,356,707,50.35360678925036
18097361300,"Census Tract 3613, Marion County, Indiana",2018,1024,704,320,68.75,31.25,121,320,37.8125
18097380402,"Census Tract 3804.02, Marion County, Indiana",2018,2029,558,1471,27.501232134056185,72.49876786594382,736,1471,50.033990482664855
18097360201,"Census Tract 3602.01, Marion County, Indiana",2018,1722,693,1029,40.24390243902439,59.75609756097561,559,1029,54.3245869776482
18097360501,"Census Tract 3605.01, Marion County, Indiana",2018,2229,1480,749,66.39748766262898,33.60251233737102,362,749,48.33110814419226
18097320303,"Census Tract 3203.03, Marion County, Indiana",2018,1773,11,1762,0.6204173716864072,99.3795826283136,561,1762,31.838819523269013
18097320902,"Census Tract 3209.02, Marion County, Indiana",2018,1643,557,1086,33.901399878271455,66.09860012172855,755,1086,69.52117863720073
18097321600,"Census Tract 3216, Marion County, Indiana",2018,2363,1120,1243,47.39737621667372,52.60262378332628,610,1243,49.074818986323415
18097340111,"Census Tract 3401.11, Marion County, Indiana",2018,1021,809,212,79.2360430950049,20.7639569049951,41,212,19.339622641509433
18097340112,"Census Tract 3401.12, Marion County, Indiana",2018,2408,1053,1355,43.72923588039867,56.27076411960133,541,1355,39.92619926199262
18097340113,"Census Tract 3401.13, Marion County, Indiana",2018,1594,1026,568,64.36637390213299,35.633626097867,453,568,79.75352112676056
18097340114,"Census Tract 3401.14, Marion County, Indiana",2018,1516,1268,248,83.64116094986808,16.358839050131927,81,248,32.66129032258065
18097340201,"Census Tract 3402.01, Marion County, Indiana",2018,1007,666,341,66.13704071499504,33.86295928500496,168,341,49.266862170087975
18097340202,"Census Tract 3402.02, Marion County, Indiana",2018,1767,567,1200,32.088285229202036,67.91171477079796,640,1200,53.333333333333336
18097340902,"Census Tract 3409.02, Marion County, Indiana",2018,2790,683,2107,24.480286738351253,75.51971326164875,867,2107,41.14855244423351
18097341904,"Census Tract 3419.04, Marion County, Indiana",2018,926,229,697,24.73002159827214,75.26997840172787,365,697,52.36728837876614
18097370301,"Census Tract 3703.01, Marion County, Indiana",2018,3299,2526,773,76.56865716883904,23.431342831160958,321,773,41.526520051746445
18097340901,"Census Tract 3409.01, Marion County, Indiana",2018,1334,1157,177,86.73163418290855,13.268365817091455,35,177,19.774011299435028
18097341903,"Census Tract 3419.03, Marion County, Indiana",2018,2028,319,1709,15.729783037475345,84.27021696252466,839,1709,49.09303686366296
18097370302,"Census Tract 3703.02, Marion County, Indiana",2018,2999,2359,640,78.6595531843948,21.3404468156052,364,640,56.875
18097380403,"Census Tract 3804.03, Marion County, Indiana",2018,1574,1016,558,64.54891994917408,35.45108005082592,194,558,34.76702508960574
18097321200,"Census Tract 3212, Marion County, Indiana",2018,2082,1742,340,83.66954851104707,16.33045148895293,56,340,16.470588235294116
18097330401,"Census Tract 3304.01, Marion County, Indiana",2018,2246,1639,607,72.97417631344612,27.025823686553874,320,607,52.71828665568369
18097330900,"Census Tract 3309, Marion County, Indiana",2018,2307,598,1709,25.921109666233203,74.0788903337668,908,1709,53.13048566413107
18097340101,"Census Tract 3401.01, Marion County, Indiana",2018,1376,1112,264,80.81395348837209,19.186046511627907,156,264,59.09090909090909
18097340600,"Census Tract 3406, Marion County, Indiana",2018,1836,914,922,49.78213507625272,50.21786492374728,523,922,56.724511930585685
18097341100,"Census Tract 3411, Marion County, Indiana",2018,738,391,347,52.981029810298104,47.018970189701896,173,347,49.85590778097983
18097342000,"Census Tract 3420, Marion County, Indiana",2018,2107,1884,223,89.41623160892264,10.583768391077362,58,223,26.00896860986547
18097350800,"Census Tract 3508, Marion County, Indiana",2018,789,282,507,35.741444866920155,64.25855513307985,325,507,64.1025641025641
18097351200,"Census Tract 3512, Marion County, Indiana",2018,898,309,589,34.4097995545657,65.59020044543429,446,589,75.72156196943973
18097352100,"Census Tract 3521, Marion County, Indiana",2018,758,327,431,43.13984168865435,56.86015831134565,270,431,62.64501160092807
18097356200,"Census Tract 3562, Marion County, Indiana",2018,997,323,674,32.397191574724175,67.60280842527582,244,674,36.201780415430264
18097357900,"Census Tract 3579, Marion County, Indiana",2018,1465,892,573,60.88737201365188,39.11262798634812,309,573,53.92670157068063
18097360101,"Census Tract 3601.01, Marion County, Indiana",2018,995,260,735,26.13065326633166,73.86934673366834,419,735,57.006802721088434
18097360402,"Census Tract 3604.02, Marion County, Indiana",2018,698,301,397,43.12320916905444,56.87679083094556,162,397,40.806045340050375
18097360700,"Census Tract 3607, Marion County, Indiana",2018,900,747,153,83,17,61,153,39.869281045751634
18097360900,"Census Tract 3609, Marion County, Indiana",2018,2486,1485,1001,59.73451327433628,40.26548672566372,646,1001,64.53546453546454
18097361000,"Census Tract 3610, Marion County, Indiana",2018,950,796,154,83.78947368421052,16.210526315789473,65,154,42.20779220779221
18097310201,"Census Tract 3102.01, Marion County, Indiana",2018,1309,831,478,63.48357524828113,36.51642475171887,333,478,69.6652719665272
18097360301,"Census Tract 3603.01, Marion County, Indiana",2018,1391,707,684,50.82674335010783,49.17325664989217,375,684,54.824561403508774
18097360401,"Census Tract 3604.01, Marion County, Indiana",2018,2368,746,1622,31.50337837837838,68.49662162162163,941,1622,58.01479654747226
18097380501,"Census Tract 3805.01, Marion County, Indiana",2018,990,692,298,69.8989898989899,30.1010101010101,147,298,49.328859060402685
18097321900,"Census Tract 3219, Marion County, Indiana",2018,1235,950,285,76.92307692307692,23.076923076923077,112,285,39.29824561403509
18097322000,"Census Tract 3220, Marion County, Indiana",2018,1344,781,563,58.11011904761905,41.88988095238095,288,563,51.15452930728242
18097322700,"Census Tract 3227, Marion County, Indiana",2018,819,661,158,80.7081807081807,19.29181929181929,108,158,68.35443037974683
18097340102,"Census Tract 3401.02, Marion County, Indiana",2018,1576,335,1241,21.256345177664976,78.74365482233503,708,1241,57.050765511684126
18097341000,"Census Tract 3410, Marion County, Indiana",2018,766,582,184,75.97911227154047,24.02088772845953,108,184,58.69565217391305
18097351000,"Census Tract 3510, Marion County, Indiana",2018,1024,456,568,44.53125,55.46875,309,568,54.401408450704224
18097380404,"Census Tract 3804.04, Marion County, Indiana",2018,1587,1063,524,66.98172652804033,33.018273471959674,290,524,55.343511450381676
18097390101,"Census Tract 3901.01, Marion County, Indiana",2018,2854,2497,357,87.49124036440084,12.508759635599159,126,357,35.294117647058826
18097390102,"Census Tract 3901.02, Marion County, Indiana",2018,2123,829,1294,39.04851625058879,60.95148374941121,886,1294,68.46986089644513
18097390404,"Census Tract 3904.04, Marion County, Indiana",2018,2206,1577,629,71.4868540344515,28.513145965548503,223,629,35.453100158982515
18097390405,"Census Tract 3904.05, Marion County, Indiana",2018,1795,781,1014,43.50974930362117,56.49025069637883,338,1014,33.333333333333336
18097390500,"Census Tract 3905, Marion County, Indiana",2018,861,392,469,45.52845528455285,54.47154471544715,262,469,55.863539445628994
18097390600,"Census Tract 3906, Marion County, Indiana",2018,2592,494,2098,19.058641975308642,80.94135802469135,1076,2098,51.28693994280267
18097390700,"Census Tract 3907, Marion County, Indiana",2018,928,354,574,38.14655172413793,61.85344827586207,320,574,55.749128919860624
18097390800,"Census Tract 3908, Marion County, Indiana",2018,1358,853,505,62.812960235640645,37.187039764359355,196,505,38.81188118811881
18097390900,"Census Tract 3909, Marion County, Indiana",2018,1320,555,765,42.04545454545455,57.95454545454545,326,765,42.61437908496732
18097391000,"Census Tract 3910, Marion County, Indiana",2018,3102,347,2755,11.186331399097357,88.81366860090264,1123,2755,40.76225045372051
18097390402,"Census Tract 3904.02, Marion County, Indiana",2018,4216,3470,746,82.30550284629982,17.69449715370019,218,746,29.222520107238605
18097321300,"Census Tract 3213, Marion County, Indiana",2018,1276,648,628,50.78369905956113,49.21630094043887,270,628,42.99363057324841
18097330103,"Census Tract 3301.03, Marion County, Indiana",2018,2596,1571,1025,60.516178736517716,39.483821263482284,511,1025,49.853658536585364
18097330600,"Census Tract 3306, Marion County, Indiana",2018,1896,1117,779,58.913502109704645,41.086497890295355,441,779,56.61103979460847
18097322600,"Census Tract 3226, Marion County, Indiana",2018,1857,350,1507,18.84760366182014,81.15239633817986,676,1507,44.857332448573324
18097321100,"Census Tract 3211, Marion County, Indiana",2018,1459,1035,424,70.93899931459904,29.06100068540096,156,424,36.79245283018868
18097320400,"Census Tract 3204, Marion County, Indiana",2018,1440,642,798,44.583333333333336,55.416666666666664,308,798,38.59649122807018
18097340800,"Census Tract 3408, Marion County, Indiana",2018,678,543,135,80.08849557522124,19.911504424778762,48,135,35.55555555555556
18097351500,"Census Tract 3515, Marion County, Indiana",2018,776,159,617,20.489690721649485,79.51030927835052,300,617,48.62236628849271
18097320903,"Census Tract 3209.03, Marion County, Indiana",2018,1621,468,1153,28.871067242442937,71.12893275755707,525,1153,45.533391153512575
18097360601,"Census Tract 3606.01, Marion County, Indiana",2018,1998,1597,401,79.92992992992993,20.07007007007007,249,401,62.094763092269325
18097320106,"Census Tract 3201.06, Marion County, Indiana",2018,883,589,294,66.7044167610419,33.295583238958095,190,294,64.62585034013605
18097322500,"Census Tract 3225, Marion County, Indiana",2018,766,168,598,21.93211488250653,78.06788511749347,292,598,48.82943143812709
18097342200,"Census Tract 3422, Marion County, Indiana",2018,1927,833,1094,43.22781525687597,56.77218474312403,560,1094,51.18829981718464
18097355600,"Census Tract 3556, Marion County, Indiana",2018,855,429,426,50.175438596491226,49.824561403508774,218,426,51.17370892018779
18097310305,"Census Tract 3103.05, Marion County, Indiana",2018,2457,928,1529,37.76963776963777,62.23036223036223,569,1529,37.21386527141923
18097322100,"Census Tract 3221, Marion County, Indiana",2018,1021,658,363,64.44662095984329,35.553379040156706,179,363,49.31129476584022
18097342300,"Census Tract 3423, Marion County, Indiana",2018,2260,1447,813,64.02654867256638,35.97345132743363,434,813,53.38253382533826
18097353300,"Census Tract 3533, Marion County, Indiana",2018,1503,208,1295,13.83898868928809,86.16101131071191,426,1295,32.8957528957529
18097357100,"Census Tract 3571, Marion County, Indiana",2018,808,468,340,57.92079207920792,42.07920792079208,171,340,50.294117647058826
18097361100,"Census Tract 3611, Marion County, Indiana",2018,1631,809,822,49.60147148988351,50.39852851011649,389,822,47.32360097323601
18097370201,"Census Tract 3702.01, Marion County, Indiana",2018,1652,805,847,48.728813559322035,51.271186440677965,338,847,39.90554899645809
18097381002,"Census Tract 3810.02, Marion County, Indiana",2018,1147,1004,143,87.53269398430689,12.467306015693113,62,143,43.35664335664335
18097390200,"Census Tract 3902, Marion County, Indiana",2018,1312,979,333,74.6189024390244,25.38109756097561,217,333,65.16516516516516
18097390403,"Census Tract 3904.03, Marion County, Indiana",2018,3375,3177,198,94.13333333333334,5.866666666666666,78,198,39.39393939393939
18097310103,"Census Tract 3101.03, Marion County, Indiana",2018,2561,2243,318,87.58297540023429,12.417024599765716,129,318,40.56603773584906
18097310105,"Census Tract 3101.05, Marion County, Indiana",2018,1556,902,654,57.969151670951156,42.030848329048844,302,654,46.17737003058104
18097310108,"Census Tract 3101.08, Marion County, Indiana",2018,1437,1186,251,82.53305497564371,17.4669450243563,150,251,59.7609561752988
18097320203,"Census Tract 3202.03, Marion County, Indiana",2018,1662,298,1364,17.930204572803852,82.06979542719615,570,1364,41.78885630498534
18097320500,"Census Tract 3205, Marion County, Indiana",2018,1435,779,656,54.285714285714285,45.714285714285715,320,656,48.78048780487805
18097320901,"Census Tract 3209.01, Marion County, Indiana",2018,2435,1770,665,72.68993839835728,27.310061601642712,369,665,55.48872180451128
18097322400,"Census Tract 3224, Marion County, Indiana",2018,1417,707,710,49.89414255469301,50.10585744530699,271,710,38.16901408450704
18097352400,"Census Tract 3524, Marion County, Indiana",2018,1359,485,874,35.68800588668138,64.31199411331862,463,874,52.974828375286044
18097352700,"Census Tract 3527, Marion County, Indiana",2018,1151,482,669,41.876629018245005,58.123370981754995,204,669,30.493273542600896
18097330700,"Census Tract 3307, Marion County, Indiana",2018,2490,1356,1134,54.45783132530121,45.54216867469879,417,1134,36.77248677248677
18097350100,"Census Tract 3501, Marion County, Indiana",2018,532,273,259,51.31578947368421,48.68421052631579,136,259,52.50965250965251
18097340400,"Census Tract 3404, Marion County, Indiana",2018,1191,511,680,42.90512174643157,57.09487825356843,313,680,46.029411764705884
18097342400,"Census Tract 3424, Marion County, Indiana",2018,532,228,304,42.857142857142854,57.142857142857146,123,304,40.46052631578947
18097342500,"Census Tract 3425, Marion County, Indiana",2018,1635,1005,630,61.46788990825688,38.53211009174312,382,630,60.63492063492063
18097350500,"Census Tract 3505, Marion County, Indiana",2018,869,389,480,44.76409666283084,55.23590333716916,189,480,39.375
18097350600,"Census Tract 3506, Marion County, Indiana",2018,1812,976,836,53.863134657836646,46.136865342163354,605,836,72.36842105263158
18097351600,"Census Tract 3516, Marion County, Indiana",2018,1045,606,439,57.99043062200957,42.00956937799043,144,439,32.80182232346242
18097354700,"Census Tract 3547, Marion County, Indiana",2018,569,245,324,43.05799648506151,56.94200351493849,211,324,65.12345679012346
18097355700,"Census Tract 3557, Marion County, Indiana",2018,925,379,546,40.972972972972975,59.027027027027025,293,546,53.663003663003664
18097357400,"Census Tract 3574, Marion County, Indiana",2018,1673,727,946,43.45487148834429,56.54512851165571,503,946,53.17124735729387
18097357800,"Census Tract 3578, Marion County, Indiana",2018,710,373,337,52.53521126760563,47.46478873239437,176,337,52.225519287833826
18097358100,"Census Tract 3581, Marion County, Indiana",2018,1084,519,565,47.87822878228782,52.12177121771218,333,565,58.93805309734513
18097360404,"Census Tract 3604.04, Marion County, Indiana",2018,2862,861,2001,30.08385744234801,69.916142557652,1320,2001,65.96701649175412
18097380502,"Census Tract 3805.02, Marion County, Indiana",2018,1486,468,1018,31.493943472409153,68.50605652759084,538,1018,52.848722986247544
18097380800,"Census Tract 3808, Marion County, Indiana",2018,1158,824,334,71.15716753022453,28.842832469775473,161,334,48.203592814371255
18097380901,"Census Tract 3809.01, Marion County, Indiana",2018,1820,1593,227,87.52747252747253,12.472527472527473,56,227,24.669603524229075
18097381101,"Census Tract 3811.01, Marion County, Indiana",2018,2479,1488,991,60.0242033077854,39.9757966922146,501,991,50.55499495459132
18097381102,"Census Tract 3811.02, Marion County, Indiana",2018,2446,1850,596,75.63368765331153,24.36631234668847,394,596,66.10738255033557
18097381204,"Census Tract 3812.04, Marion County, Indiana",2018,1581,222,1359,14.041745730550284,85.95825426944971,707,1359,52.02354672553348
18097390300,"Census Tract 3903, Marion County, Indiana",2018,1920,1837,83,95.67708333333333,4.322916666666667,18,83,21.686746987951807
18097310106,"Census Tract 3101.06, Marion County, Indiana",2018,2068,274,1794,13.249516441005802,86.75048355899419,779,1794,43.42251950947603
18097320108,"Census Tract 3201.08, Marion County, Indiana",2018,2349,251,2098,10.68539804171988,89.31460195828012,1125,2098,53.622497616777885
18097320202,"Census Tract 3202.02, Marion County, Indiana",2018,2071,1279,792,61.75760502172864,38.24239497827136,138,792,17.424242424242426
18097320301,"Census Tract 3203.01, Marion County, Indiana",2018,1829,1319,510,72.11591033351559,27.884089666484417,114,510,22.352941176470587
18097320700,"Census Tract 3207, Marion County, Indiana",2018,1080,662,418,61.2962962962963,38.7037037037037,113,418,27.033492822966508
18097321002,"Census Tract 3210.02, Marion County, Indiana",2018,1798,1283,515,71.35706340378198,28.64293659621802,203,515,39.41747572815534
18097380600,"Census Tract 3806, Marion County, Indiana",2018,2141,1057,1084,49.369453526389535,50.630546473610465,579,1084,53.413284132841326
18097321800,"Census Tract 3218, Marion County, Indiana",2018,1640,1175,465,71.64634146341463,28.353658536585368,149,465,32.043010752688176
18097322200,"Census Tract 3222, Marion County, Indiana",2018,812,607,205,74.75369458128078,25.246305418719214,76,205,37.073170731707314
18097330203,"Census Tract 3302.03, Marion County, Indiana",2018,2151,2082,69,96.79218967921896,3.2078103207810322,33,69,47.82608695652174
18097341902,"Census Tract 3419.02, Marion County, Indiana",2018,1413,1136,277,80.39631988676575,19.603680113234255,132,277,47.65342960288809
18097330204,"Census Tract 3302.04, Marion County, Indiana",2018,2084,1866,218,89.53934740882917,10.460652591170826,12,218,5.504587155963303
18097330500,"Census Tract 3305, Marion County, Indiana",2018,2643,1604,1039,60.68861142640938,39.31138857359062,689,1039,66.31376323387873
18097352300,"Census Tract 3523, Marion County, Indiana",2018,506,234,272,46.24505928853755,53.75494071146245,130,272,47.794117647058826
18097355100,"Census Tract 3551, Marion County, Indiana",2018,708,174,534,24.576271186440678,75.42372881355932,260,534,48.68913857677903
18097355300,"Census Tract 3553, Marion County, Indiana",2018,1087,478,609,43.97424103035878,56.02575896964122,306,609,50.24630541871921
18097360602,"Census Tract 3606.02, Marion County, Indiana",2018,2360,1068,1292,45.25423728813559,54.74576271186441,814,1292,63.0030959752322
18097330106,"Census Tract 3301.06, Marion County, Indiana",2018,2613,398,2215,15.23153463451971,84.7684653654803,1124,2215,50.74492099322799
18097330107,"Census Tract 3301.07, Marion County, Indiana",2018,2539,2429,110,95.6675856636471,4.332414336352895,0,110,0
18097320105,"Census Tract 3201.05, Marion County, Indiana",2018,1886,917,969,48.621420996818664,51.378579003181336,526,969,54.282765737874094
18097320204,"Census Tract 3202.04, Marion County, Indiana",2018,2633,544,2089,20.66084314470186,79.33915685529814,965,2089,46.19435136428913
18097320600,"Census Tract 3206, Marion County, Indiana",2018,1147,768,379,66.95727986050566,33.042720139494335,119,379,31.398416886543536
18097321700,"Census Tract 3217, Marion County, Indiana",2018,2032,1246,786,61.318897637795274,38.681102362204726,345,786,43.89312977099237
18097330202,"Census Tract 3302.02, Marion County, Indiana",2018,4079,2100,1979,51.48320666830105,48.51679333169895,1077,1979,54.42142496210207
18097352500,"Census Tract 3525, Marion County, Indiana",2018,1424,855,569,60.04213483146067,39.95786516853933,298,569,52.37258347978911
18097352800,"Census Tract 3528, Marion County, Indiana",2018,417,168,249,40.28776978417266,59.71223021582734,132,249,53.01204819277108
18097353600,"Census Tract 3536, Marion County, Indiana",2018,1140,366,774,32.10526315789474,67.89473684210526,539,774,69.63824289405684
18097354900,"Census Tract 3549, Marion County, Indiana",2018,1130,392,738,34.690265486725664,65.30973451327434,378,738,51.21951219512195
18097355900,"Census Tract 3559, Marion County, Indiana",2018,861,451,410,52.38095238095238,47.61904761904762,176,410,42.926829268292686
18097357000,"Census Tract 3570, Marion County, Indiana",2018,810,398,412,49.135802469135804,50.864197530864196,233,412,56.55339805825243
18097360102,"Census Tract 3601.02, Marion County, Indiana",2018,1049,463,586,44.137273593898954,55.862726406101046,293,586,50
18097380700,"Census Tract 3807, Marion County, Indiana",2018,2247,1053,1194,46.86248331108144,53.13751668891856,777,1194,65.07537688442211
18097361400,"Census Tract 3614, Marion County, Indiana",2018,4226,2912,1314,68.90676762896356,31.09323237103644,298,1314,22.678843226788434
18097361600,"Census Tract 3616, Marion County, Indiana",2018,3219,3104,115,96.42746194470332,3.572538055296676,87,115,75.65217391304348
18097380300,"Census Tract 3803, Marion County, Indiana",2018,1656,766,890,46.256038647343,53.743961352657,541,890,60.78651685393258
18097381001,"Census Tract 3810.01, Marion County, Indiana",2018,2741,728,2013,26.55964976286027,73.44035023713973,1101,2013,54.69448584202683
18097380100,"Census Tract 3801, Marion County, Indiana",2018,6844,4662,2182,68.11805961426067,31.881940385739334,1012,2182,46.3794683776352
18097381201,"Census Tract 3812.01, Marion County, Indiana",2018,2910,2085,825,71.64948453608247,28.350515463917525,321,825,38.90909090909091
18097342500,"Census Tract 3425, Marion County, Indiana",2019,1633,1000,633,61.2369871402327,38.7630128597673,386,633,60.97946287519747
18097350500,"Census Tract 3505, Marion County, Indiana",2019,902,406,496,45.011086474501106,54.988913525498894,214,496,43.145161290322584
18097350600,"Census Tract 3506, Marion County, Indiana",2019,2012,956,1056,47.514910536779325,52.485089463220675,773,1056,73.20075757575758
18097351600,"Census Tract 3516, Marion County, Indiana",2019,1117,704,413,63.0259623992838,36.9740376007162,115,413,27.84503631961259
18097352500,"Census Tract 3525, Marion County, Indiana",2019,1457,838,619,57.51544269045985,42.48455730954015,285,619,46.04200323101777
18097352800,"Census Tract 3528, Marion County, Indiana",2019,511,140,371,27.397260273972602,72.6027397260274,185,371,49.86522911051213
18097353600,"Census Tract 3536, Marion County, Indiana",2019,1216,407,809,33.4703947368421,66.52960526315789,520,809,64.27688504326329
18097354900,"Census Tract 3549, Marion County, Indiana",2019,1108,361,747,32.581227436823106,67.4187725631769,377,747,50.468540829986615
18097355900,"Census Tract 3559, Marion County, Indiana",2019,839,465,374,55.42312276519666,44.57687723480334,160,374,42.780748663101605
18097357000,"Census Tract 3570, Marion County, Indiana",2019,738,418,320,56.639566395663955,43.360433604336045,165,320,51.5625
18097360102,"Census Tract 3601.02, Marion County, Indiana",2019,1060,436,624,41.132075471698116,58.867924528301884,316,624,50.64102564102564
18097380700,"Census Tract 3807, Marion County, Indiana",2019,2245,1181,1064,52.605790645879736,47.394209354120264,584,1064,54.88721804511278
18097361400,"Census Tract 3614, Marion County, Indiana",2019,4154,2861,1293,68.87337506018295,31.126624939817045,492,1293,38.05104408352668
18097361600,"Census Tract 3616, Marion County, Indiana",2019,3293,3227,66,97.9957485575463,2.0042514424536897,38,66,57.57575757575758
18097380300,"Census Tract 3803, Marion County, Indiana",2019,1505,773,732,51.36212624584718,48.63787375415282,510,732,69.67213114754098
18097381001,"Census Tract 3810.01, Marion County, Indiana",2019,2585,687,1898,26.576402321083172,73.42359767891683,893,1898,47.0495258166491
18097380100,"Census Tract 3801, Marion County, Indiana",2019,6801,4726,2075,69.48978091457138,30.510219085428613,960,2075,46.265060240963855
18097381201,"Census Tract 3812.01, Marion County, Indiana",2019,2815,2029,786,72.07815275310834,27.92184724689165,234,786,29.770992366412212
18097360301,"Census Tract 3603.01, Marion County, Indiana",2019,1461,777,684,53.18275154004107,46.81724845995893,396,684,57.89473684210526
18097360401,"Census Tract 3604.01, Marion County, Indiana",2019,2215,583,1632,26.320541760722346,73.67945823927765,952,1632,58.333333333333336
18097380501,"Census Tract 3805.01, Marion County, Indiana",2019,926,652,274,70.41036717062634,29.58963282937365,174,274,63.503649635036496
18097390402,"Census Tract 3904.02, Marion County, Indiana",2019,4154,3332,822,80.21184400577756,19.788155994222436,240,822,29.197080291970803
18097321300,"Census Tract 3213, Marion County, Indiana",2019,1410,747,663,52.97872340425532,47.02127659574468,255,663,38.46153846153846
18097330103,"Census Tract 3301.03, Marion County, Indiana",2019,2543,1499,1044,58.94612662209988,41.05387337790012,543,1044,52.01149425287356
18097330600,"Census Tract 3306, Marion County, Indiana",2019,2120,1168,952,55.094339622641506,44.905660377358494,498,952,52.3109243697479
18097322600,"Census Tract 3226, Marion County, Indiana",2019,1909,318,1591,16.657936092194866,83.34206390780513,588,1591,36.95788812067882
18097321100,"Census Tract 3211, Marion County, Indiana",2019,1504,1095,409,72.80585106382979,27.194148936170212,150,409,36.67481662591687
18097320400,"Census Tract 3204, Marion County, Indiana",2019,1387,559,828,40.30281182408075,59.69718817591925,346,828,41.78743961352657
18097340800,"Census Tract 3408, Marion County, Indiana",2019,692,556,136,80.34682080924856,19.653179190751445,49,136,36.029411764705884
18097351500,"Census Tract 3515, Marion County, Indiana",2019,769,154,615,20.0260078023407,79.9739921976593,306,615,49.75609756097561
18097320903,"Census Tract 3209.03, Marion County, Indiana",2019,1645,505,1140,30.699088145896656,69.30091185410335,603,1140,52.89473684210526
18097360601,"Census Tract 3606.01, Marion County, Indiana",2019,2024,1589,435,78.50790513833992,21.492094861660078,252,435,57.93103448275862
18097320106,"Census Tract 3201.06, Marion County, Indiana",2019,935,544,391,58.18181818181818,41.81818181818182,262,391,67.0076726342711
18097322500,"Census Tract 3225, Marion County, Indiana",2019,796,170,626,21.35678391959799,78.64321608040201,341,626,54.47284345047923
18097342200,"Census Tract 3422, Marion County, Indiana",2019,1846,757,1089,41.00758396533045,58.99241603466955,521,1089,47.842056932966024
18097355600,"Census Tract 3556, Marion County, Indiana",2019,930,414,516,44.516129032258064,55.483870967741936,276,516,53.48837209302326
18097310305,"Census Tract 3103.05, Marion County, Indiana",2019,2517,881,1636,35.001986491855384,64.99801350814462,555,1636,33.924205378973106
18097322100,"Census Tract 3221, Marion County, Indiana",2019,959,623,336,64.96350364963503,35.03649635036496,180,336,53.57142857142857
18097342300,"Census Tract 3423, Marion County, Indiana",2019,2231,1428,803,64.00717167189602,35.99282832810399,399,803,49.68866749688667
18097353300,"Census Tract 3533, Marion County, Indiana",2019,1477,223,1254,15.098171970209885,84.90182802979011,463,1254,36.921850079744814
18097357100,"Census Tract 3571, Marion County, Indiana",2019,835,484,351,57.964071856287426,42.035928143712574,166,351,47.293447293447294
18097321002,"Census Tract 3210.02, Marion County, Indiana",2019,1764,1280,484,72.56235827664399,27.43764172335601,187,484,38.63636363636363
18097380600,"Census Tract 3806, Marion County, Indiana",2019,2190,1042,1148,47.57990867579909,52.42009132420091,603,1148,52.52613240418118
18097321800,"Census Tract 3218, Marion County, Indiana",2019,1604,1189,415,74.12718204488777,25.872817955112218,177,415,42.65060240963855
18097322200,"Census Tract 3222, Marion County, Indiana",2019,817,579,238,70.86903304773561,29.13096695226438,67,238,28.15126050420168
18097330203,"Census Tract 3302.03, Marion County, Indiana",2019,2093,2061,32,98.47109412326803,1.5289058767319637,32,32,100
18097341902,"Census Tract 3419.02, Marion County, Indiana",2019,1411,1136,275,80.51027639971652,19.489723600283487,143,275,52
18097330204,"Census Tract 3302.04, Marion County, Indiana",2019,2102,1994,108,94.86203615604187,5.137963843958135,15,108,13.88888888888889
18097330500,"Census Tract 3305, Marion County, Indiana",2019,2727,1797,930,65.8965896589659,34.103410341034106,494,930,53.11827956989247
18097352300,"Census Tract 3523, Marion County, Indiana",2019,522,220,302,42.1455938697318,57.8544061302682,116,302,38.41059602649007
18097355100,"Census Tract 3551, Marion County, Indiana",2019,711,167,544,23.488045007032348,76.51195499296765,259,544,47.61029411764706
18097355300,"Census Tract 3553, Marion County, Indiana",2019,1193,441,752,36.96563285834032,63.03436714165968,376,752,50
18097360602,"Census Tract 3606.02, Marion County, Indiana",2019,2432,1114,1318,45.80592105263158,54.19407894736842,840,1318,63.7329286798179
18097360502,"Census Tract 3605.02, Marion County, Indiana",2019,2366,1621,745,68.51225697379543,31.487743026204566,533,745,71.54362416107382
18097360800,"Census Tract 3608, Marion County, Indiana",2019,1212,311,901,25.660066006600662,74.33993399339934,544,901,60.37735849056604
18097380200,"Census Tract 3802, Marion County, Indiana",2019,1379,667,712,48.368382886149384,51.631617113850616,369,712,51.825842696629216
18097380902,"Census Tract 3809.02, Marion County, Indiana",2019,2390,1875,515,78.45188284518828,21.548117154811717,276,515,53.592233009708735
18097381203,"Census Tract 3812.03, Marion County, Indiana",2019,1021,214,807,20.959843290891282,79.04015670910871,519,807,64.31226765799256
18097320109,"Census Tract 3201.09, Marion County, Indiana",2019,1178,925,253,78.52292020373514,21.477079796264857,51,253,20.158102766798418
18097310104,"Census Tract 3101.04, Marion County, Indiana",2019,1845,952,893,51.59891598915989,48.40108401084011,274,893,30.68309070548712
18097310308,"Census Tract 3103.08, Marion County, Indiana",2019,1154,755,399,65.42461005199307,34.57538994800693,198,399,49.62406015037594
18097320107,"Census Tract 3201.07, Marion County, Indiana",2019,841,702,139,83.47205707491082,16.527942925089178,39,139,28.057553956834532
18097320800,"Census Tract 3208, Marion County, Indiana",2019,1173,1088,85,92.7536231884058,7.246376811594203,25,85,29.41176470588235
18097321200,"Census Tract 3212, Marion County, Indiana",2019,2071,1742,329,84.1139546112989,15.88604538870111,46,329,13.98176291793313
18097330401,"Census Tract 3304.01, Marion County, Indiana",2019,2255,1669,586,74.01330376940133,25.98669623059867,357,586,60.92150170648464
18097330900,"Census Tract 3309, Marion County, Indiana",2019,2369,690,1679,29.12621359223301,70.87378640776699,946,1679,56.343061346039306
18097340101,"Census Tract 3401.01, Marion County, Indiana",2019,1401,1157,244,82.58386866523911,17.416131334760884,180,244,73.77049180327869
18097340600,"Census Tract 3406, Marion County, Indiana",2019,1834,883,951,48.146128680479826,51.853871319520174,542,951,56.992639327024186
18097341100,"Census Tract 3411, Marion County, Indiana",2019,778,432,346,55.526992287917736,44.473007712082264,155,346,44.797687861271676
18097342000,"Census Tract 3420, Marion County, Indiana",2019,2053,1703,350,82.95177788602045,17.04822211397954,76,350,21.714285714285715
18097350800,"Census Tract 3508, Marion County, Indiana",2019,769,219,550,28.47854356306892,71.52145643693108,300,550,54.54545454545455
18097351200,"Census Tract 3512, Marion County, Indiana",2019,918,289,629,31.48148148148148,68.51851851851852,490,629,77.90143084260731
18097352100,"Census Tract 3521, Marion County, Indiana",2019,762,302,460,39.63254593175853,60.36745406824147,253,460,55
18097356200,"Census Tract 3562, Marion County, Indiana",2019,1018,341,677,33.49705304518664,66.50294695481335,227,677,33.53028064992615
18097361100,"Census Tract 3611, Marion County, Indiana",2019,1652,913,739,55.26634382566586,44.73365617433414,366,739,49.52638700947226
18097370201,"Census Tract 3702.01, Marion County, Indiana",2019,1645,868,777,52.765957446808514,47.234042553191486,313,777,40.283140283140284
18097357900,"Census Tract 3579, Marion County, Indiana",2019,1461,896,565,61.327857631759066,38.672142368240934,365,565,64.60176991150442
18097360101,"Census Tract 3601.01, Marion County, Indiana",2019,1073,223,850,20.782851817334574,79.21714818266543,455,850,53.529411764705884
18097360402,"Census Tract 3604.02, Marion County, Indiana",2019,716,327,389,45.67039106145251,54.32960893854749,201,389,51.670951156812336
18097360700,"Census Tract 3607, Marion County, Indiana",2019,894,761,133,85.12304250559284,14.87695749440716,60,133,45.11278195488722
18097360900,"Census Tract 3609, Marion County, Indiana",2019,2467,1333,1134,54.03323875152007,45.96676124847993,726,1134,64.02116402116403
18097361000,"Census Tract 3610, Marion County, Indiana",2019,1052,899,153,85.45627376425855,14.543726235741445,71,153,46.40522875816993
18097310201,"Census Tract 3102.01, Marion County, Indiana",2019,1433,901,532,62.875087229588274,37.124912770411726,327,532,61.46616541353384
18097381205,"Census Tract 3812.05, Marion County, Indiana",2019,2620,1225,1395,46.7557251908397,53.2442748091603,561,1395,40.215053763440864
18097321400,"Census Tract 3214, Marion County, Indiana",2019,2471,1559,912,63.09186564144071,36.90813435855929,391,912,42.87280701754386
18097322300,"Census Tract 3223, Marion County, Indiana",2019,1026,725,301,70.66276803118909,29.337231968810915,90,301,29.900332225913623
18097330105,"Census Tract 3301.05, Marion County, Indiana",2019,2595,734,1861,28.285163776493256,71.71483622350674,522,1861,28.049435787211177
18097340108,"Census Tract 3401.08, Marion County, Indiana",2019,921,130,791,14.115092290988056,85.88490770901194,292,791,36.91529709228824
18097350400,"Census Tract 3504, Marion County, Indiana",2019,1022,570,452,55.77299412915851,44.22700587084149,253,452,55.97345132743363
18097350700,"Census Tract 3507, Marion County, Indiana",2019,671,354,317,52.75707898658718,47.24292101341282,193,317,60.88328075709779
18097350900,"Census Tract 3509, Marion County, Indiana",2019,628,308,320,49.044585987261144,50.955414012738856,186,320,58.125
18097351700,"Census Tract 3517, Marion County, Indiana",2019,977,533,444,54.554759467758444,45.445240532241556,178,444,40.090090090090094
18097352600,"Census Tract 3526, Marion County, Indiana",2019,1385,577,808,41.66064981949459,58.33935018050541,402,808,49.75247524752475
18097353500,"Census Tract 3535, Marion County, Indiana",2019,1104,141,963,12.771739130434783,87.22826086956522,461,963,47.87123572170301
18097354800,"Census Tract 3548, Marion County, Indiana",2019,592,243,349,41.0472972972973,58.9527027027027,222,349,63.61031518624642
18097355000,"Census Tract 3550, Marion County, Indiana",2019,795,320,475,40.25157232704402,59.74842767295598,259,475,54.526315789473685
18097357500,"Census Tract 3575, Marion County, Indiana",2019,1346,1081,265,80.31203566121843,19.687964338781576,173,265,65.28301886792453
18097357600,"Census Tract 3576, Marion County, Indiana",2019,2217,1105,1112,49.84212900315742,50.15787099684258,685,1112,61.60071942446043
18097360202,"Census Tract 3602.02, Marion County, Indiana",2019,1245,792,453,63.6144578313253,36.3855421686747,292,453,64.45916114790288
18097310306,"Census Tract 3103.06, Marion County, Indiana",2019,2138,496,1642,23.199251637043968,76.80074836295603,638,1642,38.85505481120585
18097320304,"Census Tract 3203.04, Marion County, Indiana",2019,3186,1896,1290,59.51035781544256,40.48964218455744,406,1290,31.472868217054263
18097321001,"Census Tract 3210.01, Marion County, Indiana",2019,1062,768,294,72.31638418079096,27.683615819209038,147,294,50
18097356400,"Census Tract 3564, Marion County, Indiana",2019,1380,410,970,29.71014492753623,70.28985507246377,468,970,48.24742268041237
18097354400,"Census Tract 3544, Marion County, Indiana",2019,692,394,298,56.9364161849711,43.0635838150289,133,298,44.630872483221474
18097331000,"Census Tract 3310, Marion County, Indiana",2019,1643,978,665,59.52525867315885,40.47474132684115,380,665,57.142857142857146
18097340500,"Census Tract 3405, Marion County, Indiana",2019,1736,410,1326,23.617511520737327,76.38248847926268,634,1326,47.81297134238311
18097340700,"Census Tract 3407, Marion County, Indiana",2019,1263,531,732,42.042755344418055,57.957244655581945,332,732,45.3551912568306
18097340300,"Census Tract 3403, Marion County, Indiana",2019,2720,919,1801,33.786764705882355,66.21323529411765,1126,1801,62.52082176568573
18097341200,"Census Tract 3412, Marion County, Indiana",2019,797,318,479,39.89962358845671,60.10037641154329,314,479,65.55323590814196
18097341600,"Census Tract 3416, Marion County, Indiana",2019,844,304,540,36.018957345971565,63.981042654028435,262,540,48.51851851851852
18097342101,"Census Tract 3421.01, Marion County, Indiana",2019,1785,1146,639,64.2016806722689,35.79831932773109,445,639,69.64006259780908
18097340111,"Census Tract 3401.11, Marion County, Indiana",2019,1005,857,148,85.27363184079601,14.72636815920398,36,148,24.324324324324323
18097340112,"Census Tract 3401.12, Marion County, Indiana",2019,2481,1077,1404,43.409915356711004,56.590084643288996,553,1404,39.38746438746439
18097340113,"Census Tract 3401.13, Marion County, Indiana",2019,1590,998,592,62.76729559748428,37.23270440251572,469,592,79.22297297297297
18097340114,"Census Tract 3401.14, Marion County, Indiana",2019,1509,1245,264,82.50497017892644,17.495029821073558,100,264,37.878787878787875
18097341700,"Census Tract 3417, Marion County, Indiana",2019,1715,653,1062,38.075801749271136,61.924198250728864,691,1062,65.06591337099812
18097350300,"Census Tract 3503, Marion County, Indiana",2019,1401,86,1315,6.138472519628836,93.86152748037117,753,1315,57.26235741444867
18097351900,"Census Tract 3519, Marion County, Indiana",2019,1046,477,569,45.602294455066925,54.397705544933075,268,569,47.10017574692443
18097355400,"Census Tract 3554, Marion County, Indiana",2019,1336,504,832,37.724550898203596,62.275449101796404,313,832,37.62019230769231
18097355500,"Census Tract 3555, Marion County, Indiana",2019,1465,860,605,58.70307167235495,41.29692832764505,215,605,35.53719008264463
18097356900,"Census Tract 3569, Marion County, Indiana",2019,817,356,461,43.57405140758874,56.42594859241126,282,461,61.17136659436009
18097357200,"Census Tract 3572, Marion County, Indiana",2019,941,493,448,52.39107332624867,47.60892667375133,223,448,49.776785714285715
18097358000,"Census Tract 3580, Marion County, Indiana",2019,512,291,221,56.8359375,43.1640625,178,221,80.54298642533936
18097370202,"Census Tract 3702.02, Marion County, Indiana",2019,2519,1209,1310,47.995236204843195,52.004763795156805,763,1310,58.2442748091603
18097381002,"Census Tract 3810.02, Marion County, Indiana",2019,1143,1005,138,87.92650918635171,12.073490813648293,59,138,42.7536231884058
18097390200,"Census Tract 3902, Marion County, Indiana",2019,1487,1147,340,77.13517148621385,22.864828513786147,219,340,64.41176470588235
18097390403,"Census Tract 3904.03, Marion County, Indiana",2019,3350,3158,192,94.26865671641791,5.731343283582089,85,192,44.270833333333336
18097310103,"Census Tract 3101.03, Marion County, Indiana",2019,2691,2356,335,87.55109624674841,12.44890375325158,124,335,37.014925373134325
18097310105,"Census Tract 3101.05, Marion County, Indiana",2019,1571,899,672,57.224697644812224,42.775302355187776,370,672,55.05952380952381
18097310108,"Census Tract 3101.08, Marion County, Indiana",2019,1401,1175,226,83.86866523911492,16.131334760885082,136,226,60.176991150442475
18097320203,"Census Tract 3202.03, Marion County, Indiana",2019,1675,284,1391,16.955223880597014,83.04477611940298,635,1391,45.65061107117182
18097320500,"Census Tract 3205, Marion County, Indiana",2019,1451,819,632,56.44383184011027,43.55616815988973,339,632,53.639240506329116
18097320901,"Census Tract 3209.01, Marion County, Indiana",2019,2567,1801,766,70.15971951694586,29.840280483054148,374,766,48.825065274151434
18097322400,"Census Tract 3224, Marion County, Indiana",2019,1418,710,708,50.07052186177715,49.92947813822285,232,708,32.76836158192091
18097330106,"Census Tract 3301.06, Marion County, Indiana",2019,2497,417,2080,16.70004004805767,83.29995995194233,1016,2080,48.84615384615385
18097330107,"Census Tract 3301.07, Marion County, Indiana",2019,2506,2398,108,95.6903431763767,4.309656823623304,0,108,0
18097320105,"Census Tract 3201.05, Marion County, Indiana",2019,2082,901,1181,43.275696445725266,56.724303554274734,547,1181,46.31668077900085
18097320204,"Census Tract 3202.04, Marion County, Indiana",2019,2696,494,2202,18.323442136498517,81.67655786350149,908,2202,41.235240690281564
18097320600,"Census Tract 3206, Marion County, Indiana",2019,1197,747,450,62.40601503759399,37.59398496240601,136,450,30.22222222222222
18097321700,"Census Tract 3217, Marion County, Indiana",2019,2128,1355,773,63.67481203007519,36.32518796992481,326,773,42.17335058214748
18097330202,"Census Tract 3302.02, Marion County, Indiana",2019,4200,2144,2056,51.04761904761905,48.95238095238095,895,2056,43.53112840466926
18097352400,"Census Tract 3524, Marion County, Indiana",2019,1296,421,875,32.48456790123457,67.51543209876543,496,875,56.68571428571428
18097352700,"Census Tract 3527, Marion County, Indiana",2019,1101,465,636,42.23433242506812,57.76566757493188,205,636,32.23270440251572
18097330700,"Census Tract 3307, Marion County, Indiana",2019,2518,1295,1223,51.429706115965054,48.570293884034946,505,1223,41.29190515126737
18097350100,"Census Tract 3501, Marion County, Indiana",2019,517,320,197,61.89555125725339,38.10444874274661,76,197,38.578680203045685
18097340400,"Census Tract 3404, Marion County, Indiana",2019,1179,525,654,44.529262086513995,55.470737913486005,332,654,50.764525993883794
18097342400,"Census Tract 3424, Marion County, Indiana",2019,514,292,222,56.809338521400775,43.190661478599225,99,222,44.5945945945946
18097340201,"Census Tract 3402.01, Marion County, Indiana",2019,1032,716,316,69.37984496124031,30.62015503875969,139,316,43.9873417721519
18097340202,"Census Tract 3402.02, Marion County, Indiana",2019,1664,526,1138,31.610576923076923,68.38942307692308,554,1138,48.68189806678383
18097340902,"Census Tract 3409.02, Marion County, Indiana",2019,2821,730,2091,25.87734845799362,74.12265154200638,815,2091,38.9765662362506
18097341904,"Census Tract 3419.04, Marion County, Indiana",2019,933,255,678,27.331189710610932,72.66881028938907,313,678,46.16519174041298
18097370301,"Census Tract 3703.01, Marion County, Indiana",2019,3205,2361,844,73.66614664586584,26.333853354134167,415,844,49.170616113744074
18097340901,"Census Tract 3409.01, Marion County, Indiana",2019,1338,1159,179,86.62182361733932,13.378176382660687,69,179,38.547486033519554
18097341903,"Census Tract 3419.03, Marion County, Indiana",2019,1999,328,1671,16.408204102051027,83.59179589794897,830,1671,49.670855774985036
18097370302,"Census Tract 3703.02, Marion County, Indiana",2019,2953,2283,670,77.31120894006095,22.688791059939046,294,670,43.88059701492537
18097380403,"Census Tract 3804.03, Marion County, Indiana",2019,1563,1114,449,71.27319257837492,28.72680742162508,99,449,22.048997772828507
18097380404,"Census Tract 3804.04, Marion County, Indiana",2019,1551,1097,454,70.72856221792392,29.27143778207608,240,454,52.863436123348016
18097390101,"Census Tract 3901.01, Marion County, Indiana",2019,2841,2447,394,86.1316437873988,13.868356212601197,120,394,30.456852791878173
18097390102,"Census Tract 3901.02, Marion County, Indiana",2019,2027,841,1186,41.489886531820424,58.510113468179576,823,1186,69.3929173693086
18097390404,"Census Tract 3904.04, Marion County, Indiana",2019,2146,1649,497,76.84063373718546,23.15936626281454,159,497,31.99195171026157
18097390405,"Census Tract 3904.05, Marion County, Indiana",2019,1873,819,1054,43.72664175120128,56.27335824879872,373,1054,35.38899430740038
18097390500,"Census Tract 3905, Marion County, Indiana",2019,826,374,452,45.27845036319613,54.72154963680387,266,452,58.849557522123895
18097390600,"Census Tract 3906, Marion County, Indiana",2019,2635,568,2067,21.555977229601517,78.44402277039848,1065,2067,51.523947750362844
18097390700,"Census Tract 3907, Marion County, Indiana",2019,917,363,554,39.585605234460196,60.414394765539804,252,554,45.48736462093863
18097390800,"Census Tract 3908, Marion County, Indiana",2019,1297,816,481,62.914417887432535,37.085582112567465,192,481,39.91683991683992
18097390900,"Census Tract 3909, Marion County, Indiana",2019,1351,618,733,45.74389341228719,54.25610658771281,371,733,50.61391541609822
18097391000,"Census Tract 3910, Marion County, Indiana",2019,3290,302,2988,9.179331306990882,90.82066869300913,1077,2988,36.04417670682731
18097310110,"Census Tract 3101.10, Marion County, Indiana",2019,1427,551,876,38.6124737210932,61.3875262789068,364,876,41.55251141552512
18097360302,"Census Tract 3603.02, Marion County, Indiana",2019,886,198,688,22.34762979683973,77.65237020316027,385,688,55.9593023255814
18097361200,"Census Tract 3612, Marion County, Indiana",2019,1415,747,668,52.791519434628974,47.208480565371026,315,668,47.15568862275449
18097361300,"Census Tract 3613, Marion County, Indiana",2019,1009,711,298,70.46580773042616,29.534192269573836,136,298,45.63758389261745
18097380402,"Census Tract 3804.02, Marion County, Indiana",2019,2034,585,1449,28.761061946902654,71.23893805309734,709,1449,48.93029675638371
18097360201,"Census Tract 3602.01, Marion County, Indiana",2019,1793,647,1146,36.08477412158394,63.91522587841606,558,1146,48.69109947643979
18097360501,"Census Tract 3605.01, Marion County, Indiana",2019,2252,1447,805,64.25399644760213,35.746003552397866,323,805,40.12422360248447
18097320303,"Census Tract 3203.03, Marion County, Indiana",2019,1798,16,1782,0.8898776418242491,99.11012235817574,551,1782,30.920314253647586
18097320902,"Census Tract 3209.02, Marion County, Indiana",2019,1680,564,1116,33.57142857142857,66.42857142857143,757,1116,67.831541218638
18097321600,"Census Tract 3216, Marion County, Indiana",2019,2342,1179,1163,50.341588385994875,49.658411614005125,642,1163,55.20206362854686
18097321900,"Census Tract 3219, Marion County, Indiana",2019,1260,986,274,78.25396825396825,21.746031746031747,128,274,46.715328467153284
18097322000,"Census Tract 3220, Marion County, Indiana",2019,1312,725,587,55.25914634146341,44.74085365853659,297,587,50.59625212947189
18097322700,"Census Tract 3227, Marion County, Indiana",2019,832,694,138,83.41346153846153,16.58653846153846,84,138,60.869565217391305
18097340102,"Census Tract 3401.02, Marion County, Indiana",2019,1672,302,1370,18.0622009569378,81.9377990430622,769,1370,56.13138686131387
18097341000,"Census Tract 3410, Marion County, Indiana",2019,733,561,172,76.53478854024557,23.465211459754435,116,172,67.44186046511628
18097351000,"Census Tract 3510, Marion County, Indiana",2019,1063,444,619,41.76857949200376,58.23142050799624,312,619,50.40387722132472
18097354700,"Census Tract 3547, Marion County, Indiana",2019,594,286,308,48.148148148148145,51.851851851851855,172,308,55.84415584415584
18097355700,"Census Tract 3557, Marion County, Indiana",2019,924,357,567,38.63636363636363,61.36363636363637,288,567,50.79365079365079
18097357400,"Census Tract 3574, Marion County, Indiana",2019,1726,770,956,44.61181923522596,55.38818076477404,449,956,46.96652719665272
18097357800,"Census Tract 3578, Marion County, Indiana",2019,742,374,368,50.40431266846361,49.59568733153639,221,368,60.05434782608695
18097358100,"Census Tract 3581, Marion County, Indiana",2019,991,574,417,57.921291624621595,42.078708375378405,219,417,52.51798561151079
18097360404,"Census Tract 3604.04, Marion County, Indiana",2019,2927,941,1986,32.14895797745132,67.85104202254868,1221,1986,61.48036253776435
18097380502,"Census Tract 3805.02, Marion County, Indiana",2019,1494,447,1047,29.919678714859437,70.08032128514056,605,1047,57.78414517669532
18097380800,"Census Tract 3808, Marion County, Indiana",2019,1175,860,315,73.19148936170212,26.80851063829787,144,315,45.714285714285715
18097380901,"Census Tract 3809.01, Marion County, Indiana",2019,1794,1573,221,87.68115942028986,12.318840579710145,41,221,18.552036199095024
18097381101,"Census Tract 3811.01, Marion County, Indiana",2019,2444,1472,972,60.229132569558104,39.770867430441896,425,972,43.724279835390945
18097381102,"Census Tract 3811.02, Marion County, Indiana",2019,2359,1800,559,76.30351844001696,23.696481559983045,369,559,66.01073345259391
18097381204,"Census Tract 3812.04, Marion County, Indiana",2019,1569,204,1365,13.001912045889101,86.9980879541109,713,1365,52.234432234432234
18097390300,"Census Tract 3903, Marion County, Indiana",2019,1926,1873,53,97.24818276220145,2.751817237798546,0,53,0
18097310106,"Census Tract 3101.06, Marion County, Indiana",2019,2121,276,1845,13.012729844413013,86.98727015558698,700,1845,37.94037940379404
18097320108,"Census Tract 3201.08, Marion County, Indiana",2019,2481,256,2225,10.318419991938734,89.68158000806126,1254,2225,56.359550561797754
18097320202,"Census Tract 3202.02, Marion County, Indiana",2019,2068,1261,807,60.97678916827853,39.02321083172147,159,807,19.702602230483272
18097320301,"Census Tract 3203.01, Marion County, Indiana",2019,1772,1369,403,77.25733634311513,22.742663656884876,117,403,29.032258064516128
18097320700,"Census Tract 3207, Marion County, Indiana",2019,1132,675,457,59.628975265017665,40.371024734982335,135,457,29.54048140043764
18097310111,"Census Tract 3101.11, Marion County, Indiana",2019,1777,662,1115,37.253798536859875,62.746201463140125,548,1115,49.14798206278027
18097310204,"Census Tract 3102.04, Marion County, Indiana",2019,1845,1003,842,54.363143631436316,45.636856368563684,456,842,54.156769596199524
18097310310,"Census Tract 3103.10, Marion County, Indiana",2019,1623,1331,292,82.00862600123229,17.991373998767713,174,292,59.58904109589041
18097310203,"Census Tract 3102.03, Marion County, Indiana",2019,2226,1307,919,58.7151841868823,41.2848158131177,454,919,49.40152339499456
18097310309,"Census Tract 3103.09, Marion County, Indiana",2019,1603,341,1262,21.272613849033064,78.72738615096694,569,1262,45.08716323296355
18097310311,"Census Tract 3103.11, Marion County, Indiana",2019,1860,1702,158,91.50537634408602,8.494623655913978,78,158,49.36708860759494
18097310312,"Census Tract 3103.12, Marion County, Indiana",2019,2781,1163,1618,41.819489392304924,58.180510607695076,1058,1618,65.389369592089
18097330108,"Census Tract 3301.08, Marion County, Indiana",2019,1494,1422,72,95.18072289156626,4.819277108433735,10,72,13.88888888888889
18097330109,"Census Tract 3301.09, Marion County, Indiana",2019,2164,1951,213,90.15711645101663,9.842883548983364,76,213,35.68075117370892
18097330206,"Census Tract 3302.06, Marion County, Indiana",2019,1814,1629,185,89.80154355016538,10.19845644983462,119,185,64.32432432432432
18097330209,"Census Tract 3302.09, Marion County, Indiana",2019,3458,2779,679,80.36437246963563,19.635627530364374,347,679,51.10456553755523
18097330208,"Census Tract 3302.08, Marion County, Indiana",2019,1256,1158,98,92.19745222929936,7.802547770700637,37,98,37.755102040816325
18097330803,"Census Tract 3308.03, Marion County, Indiana",2019,1233,415,818,33.657745336577456,66.34225466342255,423,818,51.71149144254279
18097330804,"Census Tract 3308.04, Marion County, Indiana",2019,1199,205,994,17.097581317764803,82.9024186822352,420,994,42.25352112676056
18097330805,"Census Tract 3308.05, Marion County, Indiana",2019,1266,352,914,27.804107424960506,72.1958925750395,462,914,50.54704595185996
18097330806,"Census Tract 3308.06, Marion County, Indiana",2019,1607,506,1101,31.48724331051649,68.51275668948351,576,1101,52.31607629427793
18097340109,"Census Tract 3401.09, Marion County, Indiana",2019,482,252,230,52.28215767634855,47.71784232365145,76,230,33.04347826086956
18097340110,"Census Tract 3401.10, Marion County, Indiana",2019,2217,463,1754,20.884077582318447,79.11592241768155,984,1754,56.100342075256556
18097342600,"Census Tract 3426, Marion County, Indiana",2019,1113,514,599,46.18149146451033,53.81850853548967,363,599,60.60100166944908
18097354200,"Census Tract 3542, Marion County, Indiana",2019,4515,1416,3099,31.362126245847175,68.63787375415282,1297,3099,41.85221039044853
18097354500,"Census Tract 3545, Marion County, Indiana",2019,1019,390,629,38.272816486751715,61.727183513248285,322,629,51.192368839427665
18097357300,"Census Tract 3573, Marion County, Indiana",2019,853,309,544,36.225087924970694,63.774912075029306,324,544,59.55882352941177
18097360405,"Census Tract 3604.05, Marion County, Indiana",2019,2539,1631,908,64.23788893265065,35.76211106734935,374,908,41.18942731277533
18097310104,"Census Tract 3101.04, Marion County, Indiana",2020,1882,999,883,53.08182784272051,46.91817215727949,197,883,22.31030577576444
18097310105,"Census Tract 3101.05, Marion County, Indiana",2020,1763,1017,746,57.68576290414067,42.31423709585933,502,746,67.29222520107238
18097310106,"Census Tract 3101.06, Marion County, Indiana",2020,2330,223,2107,9.570815450643776,90.42918454935622,820,2107,38.91789273849074
18097310108,"Census Tract 3101.08, Marion County, Indiana",2020,1596,1298,298,81.32832080200501,18.671679197994987,133,298,44.630872483221474
18097310110,"Census Tract 3101.10, Marion County, Indiana",2020,1285,507,778,39.45525291828794,60.54474708171206,278,778,35.732647814910024
18097310111,"Census Tract 3101.11, Marion County, Indiana",2020,1529,489,1040,31.981687377370832,68.01831262262917,447,1040,42.98076923076923
18097310112,"Census Tract 3101.12, Marion County, Indiana",2020,2628,2364,264,89.95433789954338,10.045662100456621,72,264,27.272727272727273
18097310113,"Census Tract 3101.13, Marion County, Indiana",2020,340,332,8,97.6470588235294,2.3529411764705883,4,8,50
18097310201,"Census Tract 3102.01, Marion County, Indiana",2020,1466,971,495,66.23465211459754,33.765347885402456,322,495,65.05050505050505
18097310203,"Census Tract 3102.03, Marion County, Indiana",2020,1944,1139,805,58.59053497942387,41.40946502057613,417,805,51.80124223602485
18097310204,"Census Tract 3102.04, Marion County, Indiana",2020,1864,1196,668,64.16309012875537,35.836909871244636,389,668,58.23353293413174
18097310305,"Census Tract 3103.05, Marion County, Indiana",2020,2292,766,1526,33.42059336823735,66.57940663176265,404,1526,26.474442988204455
18097310306,"Census Tract 3103.06, Marion County, Indiana",2020,2423,573,1850,23.648369789517126,76.35163021048287,653,1850,35.2972972972973
18097310308,"Census Tract 3103.08, Marion County, Indiana",2020,1073,768,305,71.57502329916123,28.42497670083877,117,305,38.36065573770492
18097310309,"Census Tract 3103.09, Marion County, Indiana",2020,1426,329,1097,23.071528751753156,76.92847124824685,467,1097,42.570647219690066
18097310310,"Census Tract 3103.10, Marion County, Indiana",2020,2069,1572,497,75.97873368777186,24.02126631222813,388,497,78.06841046277665
18097310311,"Census Tract 3103.11, Marion County, Indiana",2020,1837,1697,140,92.37887860642351,7.621121393576483,76,140,54.285714285714285
18097310312,"Census Tract 3103.12, Marion County, Indiana",2020,2680,1140,1540,42.53731343283582,57.46268656716418,812,1540,52.72727272727273
18097320105,"Census Tract 3201.05, Marion County, Indiana",2020,1810,812,998,44.86187845303867,55.13812154696133,415,998,41.58316633266533
18097320106,"Census Tract 3201.06, Marion County, Indiana",2020,1206,514,692,42.62023217247098,57.37976782752902,238,692,34.39306358381503
18097320107,"Census Tract 3201.07, Marion County, Indiana",2020,845,672,173,79.5266272189349,20.473372781065088,39,173,22.54335260115607
18097320108,"Census Tract 3201.08, Marion County, Indiana",2020,2306,216,2090,9.366869037294016,90.63313096270599,1103,2090,52.77511961722488
18097320109,"Census Tract 3201.09, Marion County, Indiana",2020,1334,1085,249,81.3343328335832,18.665667166416792,39,249,15.662650602409638
18097320202,"Census Tract 3202.02, Marion County, Indiana",2020,2518,1565,953,62.15250198570294,37.84749801429706,307,953,32.21406086044071
18097320203,"Census Tract 3202.03, Marion County, Indiana",2020,1673,305,1368,18.230723251643752,81.76927674835625,598,1368,43.71345029239766
18097320205,"Census Tract 3202.05, Marion County, Indiana",2020,1213,110,1103,9.068425391591097,90.93157460840891,377,1103,34.17951042611061
18097320206,"Census Tract 3202.06, Marion County, Indiana",2020,1447,294,1153,20.317899101589497,79.68210089841051,582,1153,50.47701647875108
18097320301,"Census Tract 3203.01, Marion County, Indiana",2020,1829,1539,290,84.14434117003827,15.855658829961728,108,290,37.241379310344826
18097320303,"Census Tract 3203.03, Marion County, Indiana",2020,1663,13,1650,0.7817197835237523,99.21828021647624,642,1650,38.90909090909091
18097320305,"Census Tract 3203.05, Marion County, Indiana",2020,1053,984,69,93.44729344729345,6.552706552706553,58,69,84.05797101449275
18097320306,"Census Tract 3203.06, Marion County, Indiana",2020,2282,1004,1278,43.99649430324277,56.00350569675723,443,1278,34.66353677621283
18097320400,"Census Tract 3204, Marion County, Indiana",2020,1496,559,937,37.36631016042781,62.63368983957219,422,937,45.03735325506937
18097320500,"Census Tract 3205, Marion County, Indiana",2020,1425,756,669,53.05263157894737,46.94736842105263,427,669,63.82660687593423
18097320600,"Census Tract 3206, Marion County, Indiana",2020,1090,734,356,67.33944954128441,32.6605504587156,78,356,21.910112359550563
18097320700,"Census Tract 3207, Marion County, Indiana",2020,1130,722,408,63.89380530973451,36.10619469026549,146,408,35.78431372549019
18097320800,"Census Tract 3208, Marion County, Indiana",2020,1177,1124,53,95.49702633814783,4.502973661852167,32,53,60.37735849056604
18097320901,"Census Tract 3209.01, Marion County, Indiana",2020,2455,1752,703,71.36456211812627,28.635437881873727,347,703,49.359886201991465
18097320902,"Census Tract 3209.02, Marion County, Indiana",2020,1597,607,990,38.008766437069504,61.991233562930496,651,990,65.75757575757575
18097320903,"Census Tract 3209.03, Marion County, Indiana",2020,1843,531,1312,28.811720021703742,71.18827997829625,809,1312,61.66158536585366
18097321001,"Census Tract 3210.01, Marion County, Indiana",2020,1106,735,371,66.45569620253164,33.54430379746835,136,371,36.65768194070081
18097321002,"Census Tract 3210.02, Marion County, Indiana",2020,1778,1334,444,75.02812148481439,24.9718785151856,176,444,39.63963963963964
18097321100,"Census Tract 3211, Marion County, Indiana",2020,1464,1186,278,81.01092896174863,18.989071038251367,104,278,37.410071942446045
18097321200,"Census Tract 3212, Marion County, Indiana",2020,1925,1634,291,84.88311688311688,15.116883116883116,36,291,12.371134020618557
18097321300,"Census Tract 3213, Marion County, Indiana",2020,1409,791,618,56.139105748757984,43.860894251242016,203,618,32.84789644012945
18097321400,"Census Tract 3214, Marion County, Indiana",2020,2492,1395,1097,55.97913322632424,44.02086677367576,351,1097,31.996353691886963
18097321600,"Census Tract 3216, Marion County, Indiana",2020,2359,1164,1195,49.3429419245443,50.6570580754557,670,1195,56.06694560669456
18097321700,"Census Tract 3217, Marion County, Indiana",2020,2079,1241,838,59.69215969215969,40.30784030784031,495,838,59.069212410501194
18097321800,"Census Tract 3218, Marion County, Indiana",2020,1457,1122,335,77.00754975978037,22.99245024021963,144,335,42.985074626865675
18097321900,"Census Tract 3219, Marion County, Indiana",2020,1245,1062,183,85.3012048192771,14.698795180722891,87,183,47.540983606557376
18097322000,"Census Tract 3220, Marion County, Indiana",2020,1376,674,702,48.98255813953488,51.01744186046512,224,702,31.90883190883191
18097322100,"Census Tract 3221, Marion County, Indiana",2020,904,638,266,70.57522123893806,29.424778761061948,108,266,40.6015037593985
18097322200,"Census Tract 3222, Marion County, Indiana",2020,871,636,235,73.0195177956372,26.9804822043628,59,235,25.106382978723403
18097322300,"Census Tract 3223, Marion County, Indiana",2020,1010,631,379,62.475247524752476,37.524752475247524,91,379,24.010554089709764
18097322400,"Census Tract 3224, Marion County, Indiana",2020,1526,809,717,53.01441677588467,46.98558322411533,319,717,44.490934449093444
18097322500,"Census Tract 3225, Marion County, Indiana",2020,805,199,606,24.720496894409937,75.27950310559007,365,606,60.23102310231023
18097322601,"Census Tract 3226.01, Marion County, Indiana",2020,1024,106,918,10.3515625,89.6484375,391,918,42.592592592592595
18097322602,"Census Tract 3226.02, Marion County, Indiana",2020,850,295,555,34.705882352941174,65.29411764705883,184,555,33.153153153153156
18097322700,"Census Tract 3227, Marion County, Indiana",2020,744,618,126,83.06451612903226,16.93548387096774,34,126,26.984126984126984
18097330103,"Census Tract 3301.03, Marion County, Indiana",2020,2337,1355,982,57.980316645271714,42.019683354728286,467,982,47.55600814663951
18097330105,"Census Tract 3301.05, Marion County, Indiana",2020,2577,631,1946,24.48583624369422,75.51416375630578,529,1946,27.183967112024668
18097330106,"Census Tract 3301.06, Marion County, Indiana",2020,2413,279,2134,11.562370493162039,88.43762950683796,1063,2134,49.81255857544517
18097330107,"Census Tract 3301.07, Marion County, Indiana",2020,2412,2334,78,96.76616915422886,3.2338308457711444,0,78,0
18097330108,"Census Tract 3301.08, Marion County, Indiana",2020,1676,1491,185,88.9618138424821,11.0381861575179,11,185,5.945945945945946
18097330109,"Census Tract 3301.09, Marion County, Indiana",2020,2160,1936,224,89.62962962962963,10.37037037037037,60,224,26.785714285714285
18097330203,"Census Tract 3302.03, Marion County, Indiana",2020,1970,1942,28,98.57868020304568,1.4213197969543148,28,28,100
18097330204,"Census Tract 3302.04, Marion County, Indiana",2020,2489,2437,52,97.91080755323424,2.0891924467657694,10,52,19.23076923076923
18097330206,"Census Tract 3302.06, Marion County, Indiana",2020,1841,1599,242,86.85497012493211,13.145029875067898,124,242,51.239669421487605
18097330208,"Census Tract 3302.08, Marion County, Indiana",2020,1243,1134,109,91.2308930008045,8.769106999195495,29,109,26.605504587155963
18097330210,"Census Tract 3302.10, Marion County, Indiana",2020,2181,1569,612,71.939477303989,28.060522696011002,276,612,45.09803921568628
18097330211,"Census Tract 3302.11, Marion County, Indiana",2020,1897,632,1265,33.31576172904586,66.68423827095414,637,1265,50.355731225296445
18097330212,"Census Tract 3302.12, Marion County, Indiana",2020,1714,1343,371,78.35472578763127,21.64527421236873,181,371,48.78706199460917
18097330213,"Census Tract 3302.13, Marion County, Indiana",2020,1604,1171,433,73.00498753117208,26.99501246882793,88,433,20.323325635103927
18097330401,"Census Tract 3304.01, Marion County, Indiana",2020,2195,1705,490,77.67653758542141,22.32346241457859,277,490,56.53061224489796
18097330500,"Census Tract 3305, Marion County, Indiana",2020,2704,1848,856,68.34319526627219,31.65680473372781,420,856,49.06542056074766
18097330600,"Census Tract 3306, Marion County, Indiana",2020,2449,939,1510,38.34218048182932,61.65781951817068,1107,1510,73.3112582781457
18097330701,"Census Tract 3307.01, Marion County, Indiana",2020,986,371,615,37.62677484787018,62.37322515212982,360,615,58.53658536585366
18097330702,"Census Tract 3307.02, Marion County, Indiana",2020,1562,992,570,63.508322663252244,36.491677336747756,272,570,47.719298245614034
18097330803,"Census Tract 3308.03, Marion County, Indiana",2020,1383,417,966,30.15184381778742,69.84815618221258,371,966,38.405797101449274
18097330804,"Census Tract 3308.04, Marion County, Indiana",2020,1205,308,897,25.560165975103736,74.43983402489627,380,897,42.36343366778149
18097330805,"Census Tract 3308.05, Marion County, Indiana",2020,1067,298,769,27.928772258669166,72.07122774133083,446,769,57.99739921976593
18097330806,"Census Tract 3308.06, Marion County, Indiana",2020,1588,536,1052,33.75314861460957,66.24685138539043,580,1052,55.133079847908746
18097330900,"Census Tract 3309, Marion County, Indiana",2020,2580,674,1906,26.124031007751938,73.87596899224806,984,1906,51.62644281217209
18097331000,"Census Tract 3310, Marion County, Indiana",2020,1579,789,790,49.968334388853705,50.031665611146295,507,790,64.17721518987342
18097340101,"Census Tract 3401.01, Marion County, Indiana",2020,1937,1622,315,83.73773877129582,16.262261228704183,119,315,37.77777777777778
18097340102,"Census Tract 3401.02, Marion County, Indiana",2020,1687,307,1380,18.19798458802608,81.80201541197391,711,1380,51.52173913043478
18097340108,"Census Tract 3401.08, Marion County, Indiana",2020,953,125,828,13.116474291710388,86.88352570828961,305,828,36.83574879227053
18097340111,"Census Tract 3401.11, Marion County, Indiana",2020,940,863,77,91.80851063829788,8.191489361702128,14,77,18.181818181818183
18097340112,"Census Tract 3401.12, Marion County, Indiana",2020,2232,1026,1206,45.96774193548387,54.03225806451613,583,1206,48.34162520729685
18097340113,"Census Tract 3401.13, Marion County, Indiana",2020,1565,905,660,57.82747603833866,42.17252396166134,466,660,70.60606060606061
18097340114,"Census Tract 3401.14, Marion County, Indiana",2020,1470,1121,349,76.25850340136054,23.741496598639454,115,349,32.9512893982808
18097340115,"Census Tract 3401.15, Marion County, Indiana",2020,2667,588,2079,22.04724409448819,77.95275590551181,975,2079,46.897546897546896
18097340201,"Census Tract 3402.01, Marion County, Indiana",2020,1021,693,328,67.87463271302644,32.12536728697356,154,328,46.951219512195124
18097340202,"Census Tract 3402.02, Marion County, Indiana",2020,1619,547,1072,33.78628783199506,66.21371216800495,416,1072,38.80597014925373
18097340301,"Census Tract 3403.01, Marion County, Indiana",2020,1022,359,663,35.12720156555773,64.87279843444227,452,663,68.17496229260935
18097340302,"Census Tract 3403.02, Marion County, Indiana",2020,1630,562,1068,34.47852760736196,65.52147239263803,558,1068,52.247191011235955
18097340400,"Census Tract 3404, Marion County, Indiana",2020,1193,601,592,50.37720033528919,49.62279966471081,280,592,47.2972972972973
18097340500,"Census Tract 3405, Marion County, Indiana",2020,1987,384,1603,19.325616507297433,80.67438349270256,879,1603,54.834684965689334
18097340600,"Census Tract 3406, Marion County, Indiana",2020,1672,837,835,50.05980861244019,49.94019138755981,406,835,48.622754491017965
18097340700,"Census Tract 3407, Marion County, Indiana",2020,1385,522,863,37.68953068592058,62.31046931407942,435,863,50.405561993047506
18097340800,"Census Tract 3408, Marion County, Indiana",2020,701,579,122,82.5962910128388,17.4037089871612,41,122,33.60655737704918
18097340901,"Census Tract 3409.01, Marion County, Indiana",2020,1240,1025,215,82.66129032258064,17.338709677419356,57,215,26.511627906976745
18097340903,"Census Tract 3409.03, Marion County, Indiana",2020,915,94,821,10.273224043715848,89.72677595628416,222,821,27.040194884287455
18097340904,"Census Tract 3409.04, Marion County, Indiana",2020,2221,714,1507,32.14768122467357,67.85231877532642,428,1507,28.400796284007964
18097341000,"Census Tract 3410, Marion County, Indiana",2020,707,511,196,72.27722772277228,27.722772277227723,125,196,63.775510204081634
18097341100,"Census Tract 3411, Marion County, Indiana",2020,705,367,338,52.05673758865248,47.94326241134752,93,338,27.514792899408285
18097341200,"Census Tract 3412, Marion County, Indiana",2020,843,341,502,40.450771055753265,59.549228944246735,318,502,63.34661354581673
18097341600,"Census Tract 3416, Marion County, Indiana",2020,858,336,522,39.16083916083916,60.83916083916084,311,522,59.57854406130268
18097341701,"Census Tract 3417.01, Marion County, Indiana",2020,925,352,573,38.054054054054056,61.945945945945944,377,573,65.79406631762653
18097341702,"Census Tract 3417.02, Marion County, Indiana",2020,788,352,436,44.67005076142132,55.32994923857868,194,436,44.4954128440367
18097341902,"Census Tract 3419.02, Marion County, Indiana",2020,1496,1228,268,82.0855614973262,17.914438502673796,137,268,51.11940298507463
18097341903,"Census Tract 3419.03, Marion County, Indiana",2020,1991,465,1526,23.355097940733298,76.6449020592667,713,1526,46.72346002621232
18097341904,"Census Tract 3419.04, Marion County, Indiana",2020,812,228,584,28.07881773399015,71.92118226600985,306,584,52.397260273972606
18097342000,"Census Tract 3420, Marion County, Indiana",2020,2011,1605,406,79.81103928393834,20.18896071606166,137,406,33.74384236453202
18097342101,"Census Tract 3421.01, Marion County, Indiana",2020,1935,1248,687,64.49612403100775,35.50387596899225,367,687,53.42066957787482
18097342200,"Census Tract 3422, Marion County, Indiana",2020,1702,712,990,41.8331374853114,58.1668625146886,379,990,38.282828282828284
18097342300,"Census Tract 3423, Marion County, Indiana",2020,2263,1545,718,68.27220503756077,31.72779496243924,369,718,51.39275766016713
18097342400,"Census Tract 3424, Marion County, Indiana",2020,502,326,176,64.9402390438247,35.059760956175296,76,176,43.18181818181818
18097342500,"Census Tract 3425, Marion County, Indiana",2020,1634,994,640,60.83231334149327,39.16768665850673,362,640,56.5625
18097342600,"Census Tract 3426, Marion County, Indiana",2020,1214,589,625,48.5172981878089,51.4827018121911,266,625,42.56
18097350100,"Census Tract 3501, Marion County, Indiana",2020,492,340,152,69.10569105691057,30.89430894308943,57,152,37.5
18097350300,"Census Tract 3503, Marion County, Indiana",2020,1393,89,1304,6.389088298636037,93.61091170136396,728,1304,55.828220858895705
18097350400,"Census Tract 3504, Marion County, Indiana",2020,987,546,441,55.319148936170215,44.680851063829785,227,441,51.47392290249433
18097350500,"Census Tract 3505, Marion County, Indiana",2020,973,464,509,47.68756423432682,52.31243576567318,223,509,43.81139489194499
18097350600,"Census Tract 3506, Marion County, Indiana",2020,2201,1142,1059,51.885506587914584,48.114493412085416,738,1059,69.68838526912181
18097350700,"Census Tract 3507, Marion County, Indiana",2020,766,323,443,42.16710182767624,57.83289817232376,276,443,62.30248306997743
18097350800,"Census Tract 3508, Marion County, Indiana",2020,680,194,486,28.529411764705884,71.47058823529412,242,486,49.794238683127574
18097350900,"Census Tract 3509, Marion County, Indiana",2020,590,335,255,56.779661016949156,43.220338983050844,139,255,54.509803921568626
18097351000,"Census Tract 3510, Marion County, Indiana",2020,1098,679,419,61.83970856102004,38.16029143897996,173,419,41.288782816229116
18097351200,"Census Tract 3512, Marion County, Indiana",2020,993,309,684,31.117824773413897,68.8821752265861,419,684,61.25730994152047
18097351500,"Census Tract 3515, Marion County, Indiana",2020,898,265,633,29.510022271714924,70.48997772828508,332,633,52.44865718799368
18097351600,"Census Tract 3516, Marion County, Indiana",2020,1154,728,426,63.084922010398614,36.915077989601386,87,426,20.422535211267604
18097351700,"Census Tract 3517, Marion County, Indiana",2020,995,684,311,68.74371859296483,31.256281407035175,108,311,34.72668810289389
18097351900,"Census Tract 3519, Marion County, Indiana",2020,1063,550,513,51.74035747883349,48.25964252116651,226,513,44.05458089668616
18097352100,"Census Tract 3521, Marion County, Indiana",2020,758,360,398,47.4934036939314,52.5065963060686,182,398,45.7286432160804
18097352300,"Census Tract 3523, Marion County, Indiana",2020,533,268,265,50.28142589118199,49.71857410881801,119,265,44.905660377358494
18097352400,"Census Tract 3524, Marion County, Indiana",2020,1198,371,827,30.968280467445744,69.03171953255426,406,827,49.09310761789601
18097352500,"Census Tract 3525, Marion County, Indiana",2020,1604,856,748,53.36658354114713,46.63341645885287,438,748,58.55614973262032
18097352600,"Census Tract 3526, Marion County, Indiana",2020,1351,588,763,43.523316062176164,56.476683937823836,433,763,56.74967234600262
18097352700,"Census Tract 3527, Marion County, Indiana",2020,830,385,445,46.3855421686747,53.6144578313253,169,445,37.97752808988764
18097352800,"Census Tract 3528, Marion County, Indiana",2020,552,140,412,25.36231884057971,74.6376811594203,195,412,47.33009708737864
18097353300,"Census Tract 3533, Marion County, Indiana",2020,1348,229,1119,16.98813056379822,83.01186943620178,434,1119,38.7846291331546
18097353500,"Census Tract 3535, Marion County, Indiana",2020,1175,97,1078,8.25531914893617,91.74468085106383,628,1078,58.25602968460111
18097353600,"Census Tract 3536, Marion County, Indiana",2020,1269,364,905,28.68400315208826,71.31599684791175,488,905,53.92265193370166
18097354201,"Census Tract 3542.01, Marion County, Indiana",2020,2369,718,1651,30.308146897425075,69.69185310257492,648,1651,39.24894003634161
18097354202,"Census Tract 3542.02, Marion County, Indiana",2020,2137,679,1458,31.773514272344407,68.22648572765559,606,1458,41.56378600823045
18097354400,"Census Tract 3544, Marion County, Indiana",2020,691,423,268,61.21562952243126,38.78437047756874,122,268,45.52238805970149
18097354500,"Census Tract 3545, Marion County, Indiana",2020,969,348,621,35.913312693498455,64.08668730650155,256,621,41.22383252818035
18097354700,"Census Tract 3547, Marion County, Indiana",2020,635,288,347,45.354330708661415,54.645669291338585,150,347,43.22766570605187
18097354800,"Census Tract 3548, Marion County, Indiana",2020,533,250,283,46.90431519699813,53.09568480300187,171,283,60.42402826855124
18097354900,"Census Tract 3549, Marion County, Indiana",2020,1334,314,1020,23.53823088455772,76.46176911544228,543,1020,53.23529411764706
18097355000,"Census Tract 3550, Marion County, Indiana",2020,822,386,436,46.95863746958638,53.04136253041362,214,436,49.08256880733945
18097355100,"Census Tract 3551, Marion County, Indiana",2020,910,147,763,16.153846153846153,83.84615384615384,534,763,69.98689384010486
18097355300,"Census Tract 3553, Marion County, Indiana",2020,1112,346,766,31.115107913669064,68.88489208633094,419,766,54.699738903394255
18097355400,"Census Tract 3554, Marion County, Indiana",2020,1419,603,816,42.494714587737846,57.505285412262154,309,816,37.86764705882353
18097355500,"Census Tract 3555, Marion County, Indiana",2020,1444,836,608,57.89473684210526,42.10526315789474,126,608,20.723684210526315
18097355600,"Census Tract 3556, Marion County, Indiana",2020,869,398,471,45.79976985040276,54.20023014959724,208,471,44.16135881104034
18097355700,"Census Tract 3557, Marion County, Indiana",2020,890,433,457,48.651685393258425,51.348314606741575,221,457,48.35886214442013
18097355900,"Census Tract 3559, Marion County, Indiana",2020,864,501,363,57.986111111111114,42.013888888888886,169,363,46.5564738292011
18097356200,"Census Tract 3562, Marion County, Indiana",2020,985,319,666,32.38578680203046,67.61421319796955,213,666,31.98198198198198
18097356400,"Census Tract 3564, Marion County, Indiana",2020,1376,414,962,30.087209302325583,69.91279069767442,470,962,48.856548856548855
18097356900,"Census Tract 3569, Marion County, Indiana",2020,830,479,351,57.71084337349398,42.28915662650602,236,351,67.23646723646723
18097357000,"Census Tract 3570, Marion County, Indiana",2020,779,420,359,53.91527599486521,46.08472400513479,227,359,63.231197771587745
18097357100,"Census Tract 3571, Marion County, Indiana",2020,902,551,351,61.08647450110865,38.91352549889135,128,351,36.46723646723647
18097357200,"Census Tract 3572, Marion County, Indiana",2020,850,474,376,55.76470588235294,44.23529411764706,171,376,45.47872340425532
18097357300,"Census Tract 3573, Marion County, Indiana",2020,845,316,529,37.396449704142015,62.603550295857985,318,529,60.113421550094515
18097357400,"Census Tract 3574, Marion County, Indiana",2020,1690,936,754,55.38461538461539,44.61538461538461,379,754,50.265251989389924
18097357500,"Census Tract 3575, Marion County, Indiana",2020,1286,999,287,77.68273716951788,22.317262830482115,178,287,62.02090592334495
18097357601,"Census Tract 3576.01, Marion County, Indiana",2020,1739,1014,725,58.30937320299022,41.69062679700978,469,725,64.6896551724138
18097357602,"Census Tract 3576.02, Marion County, Indiana",2020,471,242,229,51.38004246284501,48.61995753715499,72,229,31.441048034934497
18097357800,"Census Tract 3578, Marion County, Indiana",2020,755,324,431,42.913907284768214,57.086092715231786,278,431,64.50116009280742
18097357900,"Census Tract 3579, Marion County, Indiana",2020,1366,830,536,60.76134699853587,39.23865300146413,336,536,62.6865671641791
18097358000,"Census Tract 3580, Marion County, Indiana",2020,479,231,248,48.225469728601254,51.774530271398746,200,248,80.64516129032258
18097358100,"Census Tract 3581, Marion County, Indiana",2020,958,595,363,62.10855949895616,37.89144050104384,212,363,58.40220385674931
18097360101,"Census Tract 3601.01, Marion County, Indiana",2020,1100,351,749,31.90909090909091,68.0909090909091,414,749,55.27369826435247
18097360102,"Census Tract 3601.02, Marion County, Indiana",2020,1070,419,651,39.1588785046729,60.8411214953271,353,651,54.224270353302614
18097360201,"Census Tract 3602.01, Marion County, Indiana",2020,1900,554,1346,29.157894736842106,70.84210526315789,595,1346,44.205052005943536
18097360202,"Census Tract 3602.02, Marion County, Indiana",2020,1132,725,407,64.04593639575971,35.95406360424028,252,407,61.91646191646192
18097360301,"Census Tract 3603.01, Marion County, Indiana",2020,1313,678,635,51.63747143945164,48.36252856054836,406,635,63.93700787401575
18097360302,"Census Tract 3603.02, Marion County, Indiana",2020,984,289,695,29.369918699186993,70.630081300813,441,695,63.45323741007194
18097360401,"Census Tract 3604.01, Marion County, Indiana",2020,2643,556,2087,21.03670071888006,78.96329928111994,885,2087,42.40536655486344
18097360402,"Census Tract 3604.02, Marion County, Indiana",2020,1053,422,631,40.07597340930674,59.92402659069326,462,631,73.21711568938193
18097360405,"Census Tract 3604.05, Marion County, Indiana",2020,2598,1546,1052,59.50731331793688,40.49268668206312,516,1052,49.049429657794676
18097360406,"Census Tract 3604.06, Marion County, Indiana",2020,1397,382,1015,27.344309234073013,72.65569076592699,511,1015,50.3448275862069
18097360407,"Census Tract 3604.07, Marion County, Indiana",2020,1282,678,604,52.886115444617786,47.113884555382214,356,604,58.94039735099338
18097360501,"Census Tract 3605.01, Marion County, Indiana",2020,2429,1624,805,66.85878962536023,33.14121037463977,409,805,50.807453416149066
18097360502,"Census Tract 3605.02, Marion County, Indiana",2020,2216,1657,559,74.77436823104694,25.22563176895307,440,559,78.71198568872987
18097360601,"Census Tract 3606.01, Marion County, Indiana",2020,1920,1603,317,83.48958333333333,16.510416666666668,156,317,49.21135646687697
18097360602,"Census Tract 3606.02, Marion County, Indiana",2020,2488,980,1508,39.38906752411575,60.61093247588425,1016,1508,67.37400530503979
18097360700,"Census Tract 3607, Marion County, Indiana",2020,934,760,174,81.37044967880085,18.629550321199144,69,174,39.6551724137931
18097360800,"Census Tract 3608, Marion County, Indiana",2020,1197,334,863,27.903091060985798,72.0969089390142,469,863,54.34530706836617
18097360900,"Census Tract 3609, Marion County, Indiana",2020,2505,1536,969,61.31736526946108,38.68263473053892,646,969,66.66666666666667
18097361000,"Census Tract 3610, Marion County, Indiana",2020,1078,951,127,88.21892393320965,11.781076066790353,51,127,40.15748031496063
18097361100,"Census Tract 3611, Marion County, Indiana",2020,1636,966,670,59.04645476772616,40.95354523227384,278,670,41.492537313432834
18097361200,"Census Tract 3612, Marion County, Indiana",2020,1479,717,762,48.478701825557806,51.521298174442194,282,762,37.00787401574803
18097361300,"Census Tract 3613, Marion County, Indiana",2020,1055,802,253,76.01895734597156,23.981042654028435,116,253,45.8498023715415
18097361401,"Census Tract 3614.01, Marion County, Indiana",2020,1951,1405,546,72.01435161455663,27.985648385443362,342,546,62.637362637362635
18097361402,"Census Tract 3614.02, Marion County, Indiana",2020,2129,1383,746,64.96007515265383,35.03992484734617,163,746,21.84986595174263
18097361601,"Census Tract 3616.01, Marion County, Indiana",2020,2095,2067,28,98.66348448687351,1.3365155131264916,15,28,53.57142857142857
18097361602,"Census Tract 3616.02, Marion County, Indiana",2020,1266,1197,69,94.54976303317535,5.450236966824645,0,69,0
18097370201,"Census Tract 3702.01, Marion County, Indiana",2020,1291,701,590,54.29899302865995,45.70100697134005,243,590,41.186440677966104
18097370203,"Census Tract 3702.03, Marion County, Indiana",2020,1397,723,674,51.75375805297065,48.24624194702935,467,674,69.28783382789318
18097370204,"Census Tract 3702.04, Marion County, Indiana",2020,1332,670,662,50.3003003003003,49.6996996996997,317,662,47.88519637462235
18097370303,"Census Tract 3703.03, Marion County, Indiana",2020,2238,1669,569,74.57551385165326,25.424486148346737,267,569,46.92442882249561
18097370304,"Census Tract 3703.04, Marion County, Indiana",2020,1214,1003,211,82.61943986820428,17.38056013179572,90,211,42.654028436018955
18097370305,"Census Tract 3703.05, Marion County, Indiana",2020,1695,579,1116,34.15929203539823,65.84070796460178,901,1116,80.73476702508961
18097370306,"Census Tract 3703.06, Marion County, Indiana",2020,1771,1522,249,85.94014680971203,14.059853190287972,57,249,22.89156626506024
18097380101,"Census Tract 3801.01, Marion County, Indiana",2020,2746,2299,447,83.72177713037145,16.27822286962855,174,447,38.92617449664429
18097380102,"Census Tract 3801.02, Marion County, Indiana",2020,1400,813,587,58.07142857142857,41.92857142857143,85,587,14.480408858603067
18097380103,"Census Tract 3801.03, Marion County, Indiana",2020,2706,1695,1011,62.63858093126386,37.36141906873614,516,1011,51.038575667655785
18097380200,"Census Tract 3802, Marion County, Indiana",2020,1427,715,712,50.10511562718991,49.89488437281009,445,712,62.5
18097380301,"Census Tract 3803.01, Marion County, Indiana",2020,692,444,248,64.16184971098266,35.83815028901734,210,248,84.6774193548387
18097380302,"Census Tract 3803.02, Marion County, Indiana",2020,824,328,496,39.80582524271845,60.19417475728155,313,496,63.104838709677416
18097380402,"Census Tract 3804.02, Marion County, Indiana",2020,2034,663,1371,32.59587020648968,67.40412979351032,562,1371,40.99197665937272
18097380403,"Census Tract 3804.03, Marion County, Indiana",2020,1377,1055,322,76.6158315177923,23.3841684822077,61,322,18.944099378881987
18097380404,"Census Tract 3804.04, Marion County, Indiana",2020,1547,1112,435,71.88106011635423,28.118939883645766,203,435,46.666666666666664
18097380501,"Census Tract 3805.01, Marion County, Indiana",2020,843,553,290,65.59905100830368,34.400948991696325,174,290,60
18097380502,"Census Tract 3805.02, Marion County, Indiana",2020,1397,489,908,35.003579098067284,64.99642090193271,482,908,53.08370044052864
18097380600,"Census Tract 3806, Marion County, Indiana",2020,2078,1060,1018,51.010587102983635,48.989412897016365,431,1018,42.33791748526522
18097380700,"Census Tract 3807, Marion County, Indiana",2020,2410,1213,1197,50.33195020746888,49.66804979253112,645,1197,53.88471177944862
18097380800,"Census Tract 3808, Marion County, Indiana",2020,1220,899,321,73.68852459016394,26.311475409836067,126,321,39.25233644859813
18097380901,"Census Tract 3809.01, Marion County, Indiana",2020,1852,1709,143,92.27861771058315,7.721382289416846,6,143,4.195804195804196
18097380902,"Census Tract 3809.02, Marion County, Indiana",2020,2435,1969,466,80.86242299794661,19.137577002053387,226,466,48.497854077253216
18097381002,"Census Tract 3810.02, Marion County, Indiana",2020,1285,1177,108,91.59533073929961,8.40466926070039,47,108,43.51851851851852
18097381003,"Census Tract 3810.03, Marion County, Indiana",2020,1488,629,859,42.27150537634409,57.72849462365591,390,859,45.40162980209546
18097381004,"Census Tract 3810.04, Marion County, Indiana",2020,1365,281,1084,20.586080586080588,79.41391941391942,656,1084,60.51660516605166
18097381101,"Census Tract 3811.01, Marion County, Indiana",2020,2453,1563,890,63.71789645332246,36.28210354667754,402,890,45.168539325842694
18097381102,"Census Tract 3811.02, Marion County, Indiana",2020,2588,2256,332,87.17156105100463,12.828438948995363,228,332,68.67469879518072
18097381203,"Census Tract 3812.03, Marion County, Indiana",2020,1085,273,812,25.161290322580644,74.83870967741936,487,812,59.97536945812808
18097381204,"Census Tract 3812.04, Marion County, Indiana",2020,1426,151,1275,10.5890603085554,89.4109396914446,688,1275,53.96078431372549
18097381205,"Census Tract 3812.05, Marion County, Indiana",2020,2383,1041,1342,43.684431389005454,56.315568610994546,511,1342,38.07749627421759
18097381206,"Census Tract 3812.06, Marion County, Indiana",2020,1750,926,824,52.91428571428571,47.08571428571429,163,824,19.781553398058254
18097381207,"Census Tract 3812.07, Marion County, Indiana",2020,1423,1414,9,99.3675333801827,0.6324666198172875,9,9,100
18097390102,"Census Tract 3901.02, Marion County, Indiana",2020,2274,800,1474,35.180299032541775,64.81970096745822,1035,1474,70.21709633649932
18097390103,"Census Tract 3901.03, Marion County, Indiana",2020,1230,1070,160,86.99186991869918,13.008130081300813,76,160,47.5
18097390104,"Census Tract 3901.04, Marion County, Indiana",2020,2066,1754,312,84.89835430784125,15.10164569215876,78,312,25
18097390200,"Census Tract 3902, Marion County, Indiana",2020,1699,1318,381,77.5750441436139,22.42495585638611,238,381,62.46719160104987
18097390300,"Census Tract 3903, Marion County, Indiana",2020,1969,1803,166,91.56932453021838,8.430675469781615,9,166,5.421686746987952
18097390405,"Census Tract 3904.05, Marion County, Indiana",2020,1700,844,856,49.64705882352941,50.35294117647059,214,856,25
18097390406,"Census Tract 3904.06, Marion County, Indiana",2020,1768,1599,169,90.44117647058823,9.558823529411764,86,169,50.887573964497044
18097390407,"Census Tract 3904.07, Marion County, Indiana",2020,1800,1781,19,98.94444444444444,1.0555555555555556,0,19,0
18097390408,"Census Tract 3904.08, Marion County, Indiana",2020,1655,1454,201,87.85498489425981,12.145015105740182,28,201,13.930348258706468
18097390409,"Census Tract 3904.09, Marion County, Indiana",2020,2558,2258,300,88.27208756841283,11.727912431587178,66,300,22
18097390410,"Census Tract 3904.10, Marion County, Indiana",2020,712,549,163,77.1067415730337,22.89325842696629,54,163,33.12883435582822
18097390411,"Census Tract 3904.11, Marion County, Indiana",2020,1473,964,509,65.44467073998642,34.55532926001358,304,509,59.72495088408645
18097390500,"Census Tract 3905, Marion County, Indiana",2020,900,499,401,55.44444444444444,44.55555555555556,238,401,59.35162094763092
18097390601,"Census Tract 3906.01, Marion County, Indiana",2020,1099,102,997,9.281164695177434,90.71883530482256,343,997,34.40320962888666
18097390602,"Census Tract 3906.02, Marion County, Indiana",2020,1797,472,1325,26.265998887033945,73.73400111296606,664,1325,50.113207547169814
18097390700,"Census Tract 3907, Marion County, Indiana",2020,1031,606,425,58.77788554801164,41.22211445198836,247,425,58.11764705882353
18097390801,"Census Tract 3908.01, Marion County, Indiana",2020,0,0,0,NA,NA,0,0,NA
18097390802,"Census Tract 3908.02, Marion County, Indiana",2020,1256,818,438,65.12738853503184,34.87261146496815,187,438,42.694063926940636
18097390900,"Census Tract 3909, Marion County, Indiana",2020,1391,586,805,42.12796549245147,57.87203450754853,455,805,56.52173913043478
18097391001,"Census Tract 3910.01, Marion County, Indiana",2020,462,42,420,9.090909090909092,90.9090909090909,189,420,45
18097391002,"Census Tract 3910.02, Marion County, Indiana",2020,3125,504,2621,16.128,83.872,787,2621,30.02670736360168
18097310104,"Census Tract 3101.04, Marion County, Indiana",2021,1848,905,943,48.97186147186147,51.02813852813853,140,943,14.846235418875928
18097310105,"Census Tract 3101.05, Marion County, Indiana",2021,1854,1017,837,54.85436893203884,45.14563106796116,539,837,64.39665471923536
18097310106,"Census Tract 3101.06, Marion County, Indiana",2021,2185,232,1953,10.617848970251716,89.38215102974829,643,1953,32.9237071172555
18097310108,"Census Tract 3101.08, Marion County, Indiana",2021,1619,1322,297,81.65534280420012,18.344657195799876,141,297,47.474747474747474
18097310110,"Census Tract 3101.10, Marion County, Indiana",2021,1295,472,823,36.447876447876446,63.552123552123554,298,823,36.2089914945322
18097310111,"Census Tract 3101.11, Marion County, Indiana",2021,1541,538,1003,34.91239454899416,65.08760545100584,450,1003,44.8654037886341
18097310112,"Census Tract 3101.12, Marion County, Indiana",2021,2488,2289,199,92.00160771704181,7.998392282958199,47,199,23.618090452261306
18097310113,"Census Tract 3101.13, Marion County, Indiana",2021,328,304,24,92.6829268292683,7.317073170731708,13,24,54.166666666666664
18097310201,"Census Tract 3102.01, Marion County, Indiana",2021,1523,1054,469,69.20551543007223,30.794484569927775,248,469,52.87846481876333
18097310203,"Census Tract 3102.03, Marion County, Indiana",2021,2090,1156,934,55.311004784689,44.688995215311,585,934,62.6338329764454
18097310204,"Census Tract 3102.04, Marion County, Indiana",2021,1743,1060,683,60.814687320711414,39.185312679288586,431,683,63.103953147877014
18097310305,"Census Tract 3103.05, Marion County, Indiana",2021,2388,821,1567,34.380234505862646,65.61976549413735,494,1567,31.52520740268028
18097310306,"Census Tract 3103.06, Marion County, Indiana",2021,2769,681,2088,24.593716143011918,75.40628385698808,631,2088,30.220306513409962
18097310308,"Census Tract 3103.08, Marion County, Indiana",2021,1045,854,191,81.72248803827752,18.27751196172249,139,191,72.77486910994764
18097310309,"Census Tract 3103.09, Marion County, Indiana",2021,1438,404,1034,28.094575799721834,71.90542420027816,489,1034,47.29206963249516
18097310310,"Census Tract 3103.10, Marion County, Indiana",2021,1964,1518,446,77.29124236252545,22.70875763747454,310,446,69.5067264573991
18097310311,"Census Tract 3103.11, Marion County, Indiana",2021,1853,1681,172,90.717754991905025,9.28224500809498,103,172,59.883720930232556
18097310312,"Census Tract 3103.12, Marion County, Indiana",2021,2769,1189,1580,42.93968941856266,57.06031058143734,861,1580,54.49367088607595
18097320105,"Census Tract 3201.05, Marion County, Indiana",2021,1866,871,995,46.67738478027867,53.32261521972133,414,995,41.608040201005025
18097320106,"Census Tract 3201.06, Marion County, Indiana",2021,1251,561,690,44.84412470023981,55.15587529976019,243,690,35.21739130434783
18097320107,"Census Tract 3201.07, Marion County, Indiana",2021,897,728,169,81.15942028985508,18.840579710144926,21,169,12.42603550295858
18097320108,"Census Tract 3201.08, Marion County, Indiana",2021,2300,200,2100,8.695652173913043,91.30434782608695,1012,2100,48.19047619047619
18097320109,"Census Tract 3201.09, Marion County, Indiana",2021,1360,1190,170,87.5,12.5,4,170,2.3529411764705883
18097320202,"Census Tract 3202.02, Marion County, Indiana",2021,2443,1551,892,63.48751534997953,36.51248465002047,327,892,36.65919282511211
18097320203,"Census Tract 3202.03, Marion County, Indiana",2021,1669,353,1316,21.15038945476333,78.84961054523667,607,1316,46.12462006079027
18097320205,"Census Tract 3202.05, Marion County, Indiana",2021,1231,47,1184,3.8180341186027618,96.18196588139723,506,1184,42.736486486486484
18097320206,"Census Tract 3202.06, Marion County, Indiana",2021,1377,274,1103,19.89832970225127,80.10167029774873,498,1103,45.14959202175884
18097320301,"Census Tract 3203.01, Marion County, Indiana",2021,1866,1582,284,84.78027867095392,15.219721329046088,118,284,41.54929577464789
18097320303,"Census Tract 3203.03, Marion County, Indiana",2021,1655,15,1640,0.9063444108761329,99.09365558912387,727,1640,44.329268292682926
18097320305,"Census Tract 3203.05, Marion County, Indiana",2021,1056,1014,42,96.02272727272727,3.977272727272727,33,42,78.57142857142857
18097320306,"Census Tract 3203.06, Marion County, Indiana",2021,2245,974,1271,43.385300668151444,56.614699331848556,387,1271,30.44846577498033
18097320400,"Census Tract 3204, Marion County, Indiana",2021,1461,694,767,47.501711156741955,52.498288843258045,324,767,42.24250325945241
18097320500,"Census Tract 3205, Marion County, Indiana",2021,1379,709,670,51.4140681653372,48.5859318346628,441,670,65.82089552238806
18097320600,"Census Tract 3206, Marion County, Indiana",2021,1077,744,333,69.08077994428969,30.919220055710305,89,333,26.726726726726728
18097320700,"Census Tract 3207, Marion County, Indiana",2021,1173,736,437,62.745098039215684,37.254901960784316,153,437,35.01144164759725
18097320800,"Census Tract 3208, Marion County, Indiana",2021,1178,1131,47,96.01018675721562,3.9898132427843804,10,47,21.27659574468085
18097320901,"Census Tract 3209.01, Marion County, Indiana",2021,2517,1751,766,69.56694477552642,30.43305522447358,385,766,50.26109660574413
18097320902,"Census Tract 3209.02, Marion County, Indiana",2021,1685,614,1071,36.439169139465875,63.560830860534125,685,1071,63.95891690009337
18097320903,"Census Tract 3209.03, Marion County, Indiana",2021,2020,691,1329,34.20792079207921,65.79207920792079,851,1329,64.03310759969902
18097321001,"Census Tract 3210.01, Marion County, Indiana",2021,1020,714,306,70,30,145,306,47.38562091503268
18097321002,"Census Tract 3210.02, Marion County, Indiana",2021,1879,1438,441,76.53006918573709,23.469930814262906,210,441,47.61904761904762
18097321100,"Census Tract 3211, Marion County, Indiana",2021,1521,1193,328,78.43523997370151,21.564760026298487,96,328,29.26829268292683
18097321200,"Census Tract 3212, Marion County, Indiana",2021,2019,1664,355,82.41703813769193,17.582961862308075,52,355,14.647887323943662
18097321300,"Census Tract 3213, Marion County, Indiana",2021,1387,801,586,57.75054073540014,42.24945926459986,213,586,36.3481228668942
18097321400,"Census Tract 3214, Marion County, Indiana",2021,2496,1364,1132,54.6474358974359,45.3525641025641,337,1132,29.770318021201412
18097321600,"Census Tract 3216, Marion County, Indiana",2021,2397,1323,1074,55.19399249061327,44.80600750938673,632,1074,58.845437616387336
18097321700,"Census Tract 3217, Marion County, Indiana",2021,2046,1265,781,61.82795698924731,38.17204301075269,559,781,71.57490396927017
18097321800,"Census Tract 3218, Marion County, Indiana",2021,1428,1124,304,78.71148459383754,21.288515406162464,117,304,38.48684210526316
18097321900,"Census Tract 3219, Marion County, Indiana",2021,1186,974,212,82.1247892074199,17.875210792580102,116,212,54.716981132075475
18097322000,"Census Tract 3220, Marion County, Indiana",2021,1377,719,658,52.21496005809731,47.78503994190269,230,658,34.954407294832826
18097322100,"Census Tract 3221, Marion County, Indiana",2021,950,716,234,75.36842105263158,24.63157894736842,87,234,37.17948717948718
18097322200,"Census Tract 3222, Marion County, Indiana",2021,871,636,235,73.0195177956372,26.9804822043628,64,235,27.23404255319149
18097322300,"Census Tract 3223, Marion County, Indiana",2021,997,607,390,60.88264794383149,39.11735205616851,61,390,15.64102564102564
18097322400,"Census Tract 3224, Marion County, Indiana",2021,1565,884,681,56.48562300319489,43.51437699680511,297,681,43.61233480176212
18097322500,"Census Tract 3225, Marion County, Indiana",2021,793,160,633,20.1765447667087,79.8234552332913,366,633,57.81990521327014
18097322601,"Census Tract 3226.01, Marion County, Indiana",2021,938,105,833,11.194029850746269,88.80597014925372,387,833,46.45858343337335
18097322602,"Census Tract 3226.02, Marion County, Indiana",2021,845,264,581,31.242603550295858,68.75739644970415,176,581,30.292598967297764
18097322700,"Census Tract 3227, Marion County, Indiana",2021,903,693,210,76.74418604651163,23.25581395348837,67,210,31.904761904761905
18097330103,"Census Tract 3301.03, Marion County, Indiana",2021,2214,1263,951,57.046070460704605,42.953929539295395,425,951,44.689800210304945
18097330105,"Census Tract 3301.05, Marion County, Indiana",2021,2458,665,1793,27.054515866558177,72.94548413344182,550,1793,30.67484662576687
18097330106,"Census Tract 3301.06, Marion County, Indiana",2021,2367,454,1913,19.18039712716519,80.8196028728348,934,1913,48.82383690538421
18097330107,"Census Tract 3301.07, Marion County, Indiana",2021,2295,2237,58,97.4727668845316,2.52723311546841,0,58,0
18097330108,"Census Tract 3301.08, Marion County, Indiana",2021,1601,1439,162,89.88132417239225,10.118675827607746,14,162,8.641975308641975
18097330109,"Census Tract 3301.09, Marion County, Indiana",2021,2043,1902,141,93.09838472834068,6.901615271659325,82,141,58.156028368794324
18097330203,"Census Tract 3302.03, Marion County, Indiana",2021,1864,1818,46,97.53218884120172,2.467811158798283,26,46,56.52173913043478
18097330204,"Census Tract 3302.04, Marion County, Indiana",2021,2125,2092,33,98.44705882352942,1.5529411764705883,13,33,39.39393939393939
18097330206,"Census Tract 3302.06, Marion County, Indiana",2021,1840,1679,161,91.25,8.75,81,161,50.31055900621118
18097330208,"Census Tract 3302.08, Marion County, Indiana",2021,1265,1102,163,87.11462450592886,12.885375494071146,56,163,34.355828220858896
18097330210,"Census Tract 3302.10, Marion County, Indiana",2021,2171,1738,433,80.05527406725011,19.944725932749886,172,433,39.722863741339495
18097330211,"Census Tract 3302.11, Marion County, Indiana",2021,1898,586,1312,30.874604847207586,69.12539515279241,719,1312,54.801829268292686
18097330212,"Census Tract 3302.12, Marion County, Indiana",2021,1743,1414,329,81.12449799196787,18.87550200803213,112,329,34.04255319148936
18097330213,"Census Tract 3302.13, Marion County, Indiana",2021,1564,1144,420,73.1457800511509,26.854219948849106,62,420,14.761904761904763
18097330401,"Census Tract 3304.01, Marion County, Indiana",2021,2121,1600,521,75.43611504007544,24.563884959924565,222,521,42.61036468330134
18097330500,"Census Tract 3305, Marion County, Indiana",2021,2652,1956,696,73.75565610859728,26.244343891402714,404,696,58.04597701149425
18097330600,"Census Tract 3306, Marion County, Indiana",2021,2389,911,1478,38.133110087902885,61.866889912097115,954,1478,64.54668470906631
18097330701,"Census Tract 3307.01, Marion County, Indiana",2021,1010,406,604,40.198019801980195,59.801980198019805,389,604,64.40397350993378
18097330702,"Census Tract 3307.02, Marion County, Indiana",2021,1529,1061,468,69.39175931981687,30.608240680183126,304,468,64.95726495726495
18097330803,"Census Tract 3308.03, Marion County, Indiana",2021,1400,357,1043,25.5,74.5,362,1043,34.70757430488974
18097330804,"Census Tract 3308.04, Marion County, Indiana",2021,1218,393,825,32.26600985221675,67.73399014778325,378,825,45.81818181818182
18097330805,"Census Tract 3308.05, Marion County, Indiana",2021,1046,269,777,25.717017208413,74.282982791587,461,777,59.33075933075933
18097330806,"Census Tract 3308.06, Marion County, Indiana",2021,1538,459,1079,29.843953185955787,70.15604681404422,612,1079,56.7191844300278
18097330900,"Census Tract 3309, Marion County, Indiana",2021,2685,709,1976,26.405959031657357,73.59404096834264,959,1976,48.53238866396761
18097331000,"Census Tract 3310, Marion County, Indiana",2021,1532,742,790,48.43342036553525,51.56657963446475,575,790,72.78481012658227
18097340101,"Census Tract 3401.01, Marion County, Indiana",2021,1909,1601,308,83.86589837611315,16.134101623886853,91,308,29.545454545454547
18097340102,"Census Tract 3401.02, Marion County, Indiana",2021,1765,301,1464,17.053824362606232,82.94617563739376,736,1464,50.27322404371585
18097340108,"Census Tract 3401.08, Marion County, Indiana",2021,1151,141,1010,12.250217202432667,87.74978279756733,316,1010,31.287128712871286
18097340111,"Census Tract 3401.11, Marion County, Indiana",2021,952,833,119,87.5,12.5,74,119,62.18487394957983
18097340112,"Census Tract 3401.12, Marion County, Indiana",2021,2204,1031,1173,46.77858439201452,53.22141560798548,673,1173,57.37425404944587
18097340113,"Census Tract 3401.13, Marion County, Indiana",2021,1622,961,661,59.2478421701603,40.7521578298397,448,661,67.77609682299546
18097340114,"Census Tract 3401.14, Marion County, Indiana",2021,1655,1335,320,80.66465256797584,19.335347432024168,111,320,34.6875
18097340115,"Census Tract 3401.15, Marion County, Indiana",2021,2790,668,2122,23.942652329749105,76.05734767025089,954,2122,44.95758718190386
18097340201,"Census Tract 3402.01, Marion County, Indiana",2021,1187,813,374,68.49199663016007,31.508003369839933,144,374,38.50267379679144
18097340202,"Census Tract 3402.02, Marion County, Indiana",2021,1927,698,1229,36.222106901920085,63.777893098079915,511,1229,41.57851912123678
18097340301,"Census Tract 3403.01, Marion County, Indiana",2021,1077,478,599,44.38254410399257,55.61745589600743,375,599,62.60434056761269
18097340302,"Census Tract 3403.02, Marion County, Indiana",2021,1728,630,1098,36.458333333333336,63.541666666666664,523,1098,47.63205828779599
18097340400,"Census Tract 3404, Marion County, Indiana",2021,1269,643,626,50.66981875492514,49.33018124507486,330,626,52.715654952076676
18097340500,"Census Tract 3405, Marion County, Indiana",2021,2112,374,1738,17.708333333333332,82.29166666666667,848,1738,48.791714614499426
18097340600,"Census Tract 3406, Marion County, Indiana",2021,1754,856,898,48.80273660205245,51.19726339794755,385,898,42.87305122494432
18097340700,"Census Tract 3407, Marion County, Indiana",2021,1442,612,830,42.44105409153953,57.55894590846047,468,830,56.3855421686747
18097340800,"Census Tract 3408, Marion County, Indiana",2021,776,634,142,81.70103092783505,18.298969072164947,50,142,35.2112676056338
18097340901,"Census Tract 3409.01, Marion County, Indiana",2021,1292,1084,208,83.90092879256966,16.09907120743034,112,208,53.84615384615385
18097340903,"Census Tract 3409.03, Marion County, Indiana",2021,1012,183,829,18.08300395256917,81.91699604743083,271,829,32.68998793727383
18097340904,"Census Tract 3409.04, Marion County, Indiana",2021,2406,857,1549,35.619285120532005,64.380714879468,568,1549,36.66881859264041
18097341000,"Census Tract 3410, Marion County, Indiana",2021,801,633,168,79.02621722846442,20.973782771535582,107,168,63.69047619047619
18097341100,"Census Tract 3411, Marion County, Indiana",2021,754,343,411,45.49071618037135,54.50928381962865,142,411,34.54987834549878
18097341200,"Census Tract 3412, Marion County, Indiana",2021,784,383,401,48.85204081632653,51.14795918367347,244,401,60.84788029925187
18097341600,"Census Tract 3416, Marion County, Indiana",2021,860,303,557,35.23255813953488,64.76744186046511,348,557,62.47755834829444
18097341701,"Census Tract 3417.01, Marion County, Indiana",2021,887,445,442,50.16910935738444,49.83089064261556,305,442,69.00452488687783
18097341702,"Census Tract 3417.02, Marion County, Indiana",2021,827,352,475,42.56348246674728,57.43651753325272,220,475,46.31578947368421
18097341902,"Census Tract 3419.02, Marion County, Indiana",2021,1589,1313,276,82.63058527375708,17.36941472624292,118,276,42.7536231884058
18097341903,"Census Tract 3419.03, Marion County, Indiana",2021,2065,393,1672,19.031476997578693,80.9685230024213,749,1672,44.79665071770335
18097341904,"Census Tract 3419.04, Marion County, Indiana",2021,927,323,604,34.84358144552319,65.1564185544768,342,604,56.62251655629139
18097342000,"Census Tract 3420, Marion County, Indiana",2021,2134,1741,393,81.58388003748829,18.416119962511715,171,393,43.51145038167939
18097342101,"Census Tract 3421.01, Marion County, Indiana",2021,2095,1296,799,61.86157517899761,38.13842482100239,376,799,47.05882352941177
18097342200,"Census Tract 3422, Marion County, Indiana",2021,1762,970,792,55.05107832009081,44.94892167990919,317,792,40.025252525252526
18097342300,"Census Tract 3423, Marion County, Indiana",2021,2355,1428,927,60.63694267515923,39.36305732484077,283,927,30.528586839266453
18097342400,"Census Tract 3424, Marion County, Indiana",2021,524,298,226,56.87022900763359,43.12977099236641,91,226,40.26548672566372
18097342500,"Census Tract 3425, Marion County, Indiana",2021,1718,1049,669,61.05937136204889,38.94062863795111,388,669,57.997010463378174
18097342600,"Census Tract 3426, Marion County, Indiana",2021,1170,650,520,55.55555555555556,44.44444444444444,191,520,36.73076923076923
18097350100,"Census Tract 3501, Marion County, Indiana",2021,550,378,172,68.72727272727273,31.272727272727273,78,172,45.348837209302324
18097350300,"Census Tract 3503, Marion County, Indiana",2021,1520,139,1381,9.144736842105264,90.85526315789474,784,1381,56.77045619116582
18097350400,"Census Tract 3504, Marion County, Indiana",2021,1097,627,470,57.15587967183227,42.84412032816773,256,470,54.46808510638298
18097350500,"Census Tract 3505, Marion County, Indiana",2021,1006,487,519,48.409542743538765,51.590457256461235,199,519,38.34296724470135
18097350600,"Census Tract 3506, Marion County, Indiana",2021,2296,1364,932,59.40766550522648,40.59233449477352,738,932,79.18454935622317
18097350700,"Census Tract 3507, Marion County, Indiana",2021,776,281,495,36.21134020618557,63.78865979381443,358,495,72.32323232323232
18097350800,"Census Tract 3508, Marion County, Indiana",2021,787,275,512,34.9428208386277,65.0571791613723,257,512,50.1953125
18097350900,"Census Tract 3509, Marion County, Indiana",2021,677,395,282,58.34564254062038,41.65435745937962,125,282,44.326241134751776
18097351000,"Census Tract 3510, Marion County, Indiana",2021,1072,663,409,61.84701492537314,38.15298507462686,159,409,38.87530562347188
18097351200,"Census Tract 3512, Marion County, Indiana",2021,1060,402,658,37.924528301886795,62.075471698113205,392,658,59.57446808510638
18097351500,"Census Tract 3515, Marion County, Indiana",2021,894,266,628,29.75391498881432,70.24608501118568,370,628,58.9171974522293
18097351600,"Census Tract 3516, Marion County, Indiana",2021,1221,795,426,65.1105651105651,34.88943488943489,104,426,24.413145539906104
18097351700,"Census Tract 3517, Marion County, Indiana",2021,1029,698,331,67.83284742468416,32.16715257531584,93,331,28.09667673716012
18097351900,"Census Tract 3519, Marion County, Indiana",2021,1056,582,474,55.11363636363637,44.88636363636363,247,474,52.10970464135021
18097352100,"Census Tract 3521, Marion County, Indiana",2021,789,375,414,47.52851711026616,52.47148288973384,193,414,46.61835748792271
18097352300,"Census Tract 3523, Marion County, Indiana",2021,578,233,345,40.311418685121104,59.688581314878896,170,345,49.27536231884058
18097352400,"Census Tract 3524, Marion County, Indiana",2021,1319,403,916,30.553449583017436,69.44655041698256,529,916,57.751091703056765
18097352500,"Census Tract 3525, Marion County, Indiana",2021,1643,867,776,52.76932440657334,47.23067559342666,411,776,52.9639175257732
18097352600,"Census Tract 3526, Marion County, Indiana",2021,1410,684,726,48.51063829787234,51.48936170212766,470,726,64.73829201101928
18097352700,"Census Tract 3527, Marion County, Indiana",2021,920,502,418,54.56521739130435,45.43478260869565,220,418,52.63157894736842
18097352800,"Census Tract 3528, Marion County, Indiana",2021,573,147,426,25.654450261780106,74.3455497382199,204,426,47.88732394366197
18097353300,"Census Tract 3533, Marion County, Indiana",2021,1457,340,1117,23.335621139327387,76.66437886067261,494,1117,44.225604297224706
18097353500,"Census Tract 3535, Marion County, Indiana",2021,1192,100,1092,8.389261744966444,91.61073825503355,582,1092,53.2967032967033
18097353600,"Census Tract 3536, Marion County, Indiana",2021,1298,419,879,32.280431432973806,67.7195685670262,436,879,49.60182025028441
18097354201,"Census Tract 3542.01, Marion County, Indiana",2021,2476,637,1839,25.726978998384492,74.2730210016155,675,1839,36.7047308319739
18097354202,"Census Tract 3542.02, Marion County, Indiana",2021,2265,691,1574,30.507726269315672,69.49227373068433,727,1574,46.18805590851334
18097354400,"Census Tract 3544, Marion County, Indiana",2021,719,459,260,63.83866481223922,36.16133518776078,117,260,45
18097354500,"Census Tract 3545, Marion County, Indiana",2021,991,375,616,37.84056508577195,62.15943491422805,271,616,43.993506493506494
18097354700,"Census Tract 3547, Marion County, Indiana",2021,681,290,391,42.584434654919235,57.415565345080765,167,391,42.710997442455245
18097354800,"Census Tract 3548, Marion County, Indiana",2021,552,328,224,59.42028985507246,40.57971014492754,90,224,40.17857142857143
18097354900,"Census Tract 3549, Marion County, Indiana",2021,1390,387,1003,27.841726618705035,72.15827338129496,477,1003,47.557328015952145
18097355000,"Census Tract 3550, Marion County, Indiana",2021,788,358,430,45.431472081218274,54.568527918781726,204,430,47.44186046511628
18097355100,"Census Tract 3551, Marion County, Indiana",2021,959,172,787,17.935349322210637,82.06465067778936,518,787,65.81956797966963
18097355300,"Census Tract 3553, Marion County, Indiana",2021,1187,331,856,27.885425442291492,72.11457455770851,475,856,55.49065420560748
18097355400,"Census Tract 3554, Marion County, Indiana",2021,1453,550,903,37.85271851342051,62.14728148657949,323,903,35.76965669988926
18097355500,"Census Tract 3555, Marion County, Indiana",2021,1491,948,543,63.58148893360161,36.41851106639839,120,543,22.099447513812155
18097355600,"Census Tract 3556, Marion County, Indiana",2021,878,419,459,47.722095671981776,52.277904328018224,214,459,46.62309368191721
18097355700,"Census Tract 3557, Marion County, Indiana",2021,915,439,476,47.978142076502735,52.021857923497265,270,476,56.72268907563025
18097355900,"Census Tract 3559, Marion County, Indiana",2021,945,571,374,60.423280423280424,39.576719576719576,161,374,43.04812834224599
18097356200,"Census Tract 3562, Marion County, Indiana",2021,1104,317,787,28.713768115942027,71.28623188405797,193,787,24.52350698856417
18097356400,"Census Tract 3564, Marion County, Indiana",2021,1555,404,1151,25.980707395498392,74.0192926045016,467,1151,40.57341442224153
18097356900,"Census Tract 3569, Marion County, Indiana",2021,870,501,369,57.58620689655172,42.41379310344828,210,369,56.91056910569106
18097357000,"Census Tract 3570, Marion County, Indiana",2021,817,492,325,60.2203182374541,39.7796817625459,205,325,63.07692307692308
18097357100,"Census Tract 3571, Marion County, Indiana",2021,954,570,384,59.74842767295598,40.25157232704402,107,384,27.864583333333332
18097357200,"Census Tract 3572, Marion County, Indiana",2021,970,569,401,58.65979381443299,41.34020618556701,167,401,41.64588528678304
18097357300,"Census Tract 3573, Marion County, Indiana",2021,893,298,595,33.370660694288915,66.62933930571108,363,595,61.00840336134454
18097357400,"Census Tract 3574, Marion County, Indiana",2021,1677,878,799,52.355396541443056,47.644603458556944,357,799,44.680851063829785
18097357500,"Census Tract 3575, Marion County, Indiana",2021,1280,968,312,75.625,24.375,203,312,65.06410256410257
18097357601,"Census Tract 3576.01, Marion County, Indiana",2021,1855,941,914,50.7277628032345,49.2722371967655,567,914,62.03501094091904
18097357602,"Census Tract 3576.02, Marion County, Indiana",2021,485,269,216,55.4639175257732,44.5360824742268,63,216,29.166666666666668
18097357800,"Census Tract 3578, Marion County, Indiana",2021,716,329,387,45.94972067039106,54.05027932960894,281,387,72.60981912144703
18097357900,"Census Tract 3579, Marion County, Indiana",2021,1418,836,582,58.956276445698165,41.043723554301835,347,582,59.62199312714777
18097358000,"Census Tract 3580, Marion County, Indiana",2021,505,228,277,45.148514851485146,54.851485148514854,246,277,88.8086642599278
18097358100,"Census Tract 3581, Marion County, Indiana",2021,944,634,310,67.16101694915254,32.83898305084746,170,310,54.83870967741935
18097360101,"Census Tract 3601.01, Marion County, Indiana",2021,1024,377,647,36.81640625,63.18359375,311,647,48.068006182380216
18097360102,"Census Tract 3601.02, Marion County, Indiana",2021,1027,484,543,47.127555988315486,52.872444011684514,316,543,58.195211786372006
18097360201,"Census Tract 3602.01, Marion County, Indiana",2021,2017,536,1481,26.574119980168568,73.42588001983144,761,1481,51.38419986495611
18097360202,"Census Tract 3602.02, Marion County, Indiana",2021,1071,706,365,65.91970121381885,34.08029878618114,217,365,59.45205479452055
18097360301,"Census Tract 3603.01, Marion County, Indiana",2021,1303,679,624,52.1105141980046,47.8894858019954,417,624,66.82692307692308
18097360302,"Census Tract 3603.02, Marion County, Indiana",2021,1015,312,703,30.738916256157637,69.26108374384236,478,703,67.994310099573255
18097360401,"Census Tract 3604.01, Marion County, Indiana",2021,2660,564,2096,21.203007518796994,78.796992481203,997,2096,47.56679389312977
18097360402,"Census Tract 3604.02, Marion County, Indiana",2021,1095,429,666,39.178082191780824,60.821917808219176,465,666,69.81981981981981
18097360405,"Census Tract 3604.05, Marion County, Indiana",2021,2554,1569,985,61.433046202036024,38.566953797963976,388,985,39.390862944162436
18097360406,"Census Tract 3604.06, Marion County, Indiana",2021,1421,339,1082,23.856439127375086,76.14356087262492,475,1082,43.90018484288355
18097360407,"Census Tract 3604.07, Marion County, Indiana",2021,1278,738,540,57.74647887323944,42.25352112676056,244,540,45.18518518518518
18097360501,"Census Tract 3605.01, Marion County, Indiana",2021,2490,1764,726,70.8433734939759,29.156626506024097,360,726,49.586776859504134
18097360502,"Census Tract 3605.02, Marion County, Indiana",2021,2174,1653,521,76.03495860165593,23.965041398344066,388,521,74.4721689059501
18097360601,"Census Tract 3606.01, Marion County, Indiana",2021,1881,1570,311,83.4662413609782,16.533758639021798,176,311,56.59163987138264
18097360602,"Census Tract 3606.02, Marion County, Indiana",2021,2429,1046,1383,43.062988884314535,56.937011115685465,854,1383,61.749819233550255
18097360700,"Census Tract 3607, Marion County, Indiana",2021,928,727,201,78.34051724137932,21.65948275862069,93,201,46.26865671641791
18097360800,"Census Tract 3608, Marion County, Indiana",2021,1262,365,897,28.922345483359745,71.07765451664025,463,897,51.6164994425864
18097360900,"Census Tract 3609, Marion County, Indiana",2021,2450,1487,963,60.69387755102041,39.30612244897959,562,963,58.359293873312566
18097361000,"Census Tract 3610, Marion County, Indiana",2021,1052,942,110,89.54372623574145,10.456273764258555,52,110,47.27272727272727
18097361100,"Census Tract 3611, Marion County, Indiana",2021,1573,963,610,61.22059758423395,38.77940241576605,300,610,49.18032786885246
18097361200,"Census Tract 3612, Marion County, Indiana",2021,1464,752,712,51.36612021857923,48.63387978142077,323,712,45.36516853932584
18097361300,"Census Tract 3613, Marion County, Indiana",2021,1056,821,235,77.74621212121212,22.25378787878788,117,235,49.787234042553195
18097361401,"Census Tract 3614.01, Marion County, Indiana",2021,1899,1289,610,67.87783043707215,32.12216956292786,360,610,59.01639344262295
18097361402,"Census Tract 3614.02, Marion County, Indiana",2021,2091,1334,757,63.79722620755619,36.20277379244381,314,757,41.479524438573314
18097361601,"Census Tract 3616.01, Marion County, Indiana",2021,2008,1930,78,96.11553784860558,3.8844621513944224,64,78,82.05128205128206
18097361602,"Census Tract 3616.02, Marion County, Indiana",2021,1283,1241,42,96.72642244738893,3.273577552611068,0,42,0
18097370201,"Census Tract 3702.01, Marion County, Indiana",2021,1305,722,583,55.32567049808429,44.67432950191571,238,583,40.82332761578044
18097370203,"Census Tract 3702.03, Marion County, Indiana",2021,1473,763,710,51.799049558723695,48.200950441276305,412,710,58.028169014084504
18097370204,"Census Tract 3702.04, Marion County, Indiana",2021,1390,777,613,55.89928057553957,44.10071942446043,297,613,48.450244698205545
18097370303,"Census Tract 3703.03, Marion County, Indiana",2021,2344,1685,659,71.88566552901024,28.11433447098976,283,659,42.943854324734446
18097370304,"Census Tract 3703.04, Marion County, Indiana",2021,1345,1139,206,84.68401486988847,15.315985130111525,98,206,47.57281553398058
18097370305,"Census Tract 3703.05, Marion County, Indiana",2021,1670,661,1009,39.58083832335329,60.41916167664671,796,1009,78.88999008919723
18097370306,"Census Tract 3703.06, Marion County, Indiana",2021,1949,1671,278,85.7362750128271,14.263724987172909,59,278,21.223021582733814
18097380101,"Census Tract 3801.01, Marion County, Indiana",2021,2974,2523,451,84.83523873570948,15.164761264290517,141,451,31.263858093126387
18097380102,"Census Tract 3801.02, Marion County, Indiana",2021,1381,809,572,58.58073859522086,41.41926140477914,49,572,8.566433566433567
18097380103,"Census Tract 3801.03, Marion County, Indiana",2021,2964,1725,1239,58.19838056680162,41.80161943319838,619,1239,49.95964487489911
18097380200,"Census Tract 3802, Marion County, Indiana",2021,1504,775,729,51.52925531914894,48.47074468085106,511,729,70.0960219478738
18097380301,"Census Tract 3803.01, Marion County, Indiana",2021,762,516,246,67.71653543307086,32.28346456692913,221,246,89.83739837398375
18097380302,"Census Tract 3803.02, Marion County, Indiana",2021,883,365,518,41.33635334088335,58.66364665911665,297,518,57.335907335907336
18097380402,"Census Tract 3804.02, Marion County, Indiana",2021,2096,678,1418,32.347328244274806,67.6526717557252,657,1418,46.33286318758815
18097380403,"Census Tract 3804.03, Marion County, Indiana",2021,1465,1148,317,78.3617747440273,21.638225255972696,47,317,14.826498422712934
18097380404,"Census Tract 3804.04, Marion County, Indiana",2021,1590,1198,392,75.34591194968553,24.654088050314467,252,392,64.28571428571429
18097380501,"Census Tract 3805.01, Marion County, Indiana",2021,936,571,365,61.004273504273506,38.995726495726494,234,365,64.10958904109589
18097380502,"Census Tract 3805.02, Marion County, Indiana",2021,1534,464,1070,30.247718383311604,69.75228161668839,636,1070,59.4392523364486
18097380600,"Census Tract 3806, Marion County, Indiana",2021,2082,1032,1050,49.56772334293948,50.43227665706052,408,1050,38.857142857142854
18097380700,"Census Tract 3807, Marion County, Indiana",2021,2564,1307,1257,50.97503900156006,49.02496099843994,777,1257,61.81384248210024
18097380800,"Census Tract 3808, Marion County, Indiana",2021,1244,912,332,73.31189710610933,26.688102893890676,133,332,40.06024096385542
18097380901,"Census Tract 3809.01, Marion County, Indiana",2021,1968,1853,115,94.15650406504065,5.84349593495935,8,115,6.956521739130435
18097380902,"Census Tract 3809.02, Marion County, Indiana",2021,2587,1845,742,71.31812910707383,28.68187089292617,250,742,33.692722371967655
18097381002,"Census Tract 3810.02, Marion County, Indiana",2021,1365,1252,113,91.72161172161172,8.27838827838828,40,113,35.39823008849557
18097381003,"Census Tract 3810.03, Marion County, Indiana",2021,1456,570,886,39.14835164835165,60.85164835164835,337,886,38.036117381489845
18097381004,"Census Tract 3810.04, Marion County, Indiana",2021,1478,309,1169,20.90663058186739,79.09336941813261,699,1169,59.79469632164243
18097381101,"Census Tract 3811.01, Marion County, Indiana",2021,2540,1611,929,63.425196850393704,36.574803149606296,461,929,49.6232508073197
18097381102,"Census Tract 3811.02, Marion County, Indiana",2021,2674,2171,503,81.18922961854899,18.81077038145101,196,503,38.9662027833002
18097381203,"Census Tract 3812.03, Marion County, Indiana",2021,1175,277,898,23.574468085106382,76.42553191489361,546,898,60.801781737193764
18097381204,"Census Tract 3812.04, Marion County, Indiana",2021,1393,158,1235,11.342426417803303,88.6575735821967,746,1235,60.40485829959514
18097381205,"Census Tract 3812.05, Marion County, Indiana",2021,2580,1172,1408,45.42635658914729,54.57364341085271,516,1408,36.64772727272727
18097381206,"Census Tract 3812.06, Marion County, Indiana",2021,1723,872,851,50.6094022054556,49.3905977945444,233,851,27.37955346650999
18097381207,"Census Tract 3812.07, Marion County, Indiana",2021,1545,1522,23,98.51132686084142,1.4886731391585761,14,23,60.869565217391305
18097390102,"Census Tract 3901.02, Marion County, Indiana",2021,2603,990,1613,38.03303880138302,61.96696119861698,1075,1613,66.64600123992561
18097390103,"Census Tract 3901.03, Marion County, Indiana",2021,1277,1124,153,88.01879404855129,11.981205951448707,70,153,45.751633986928105
18097390104,"Census Tract 3901.04, Marion County, Indiana",2021,2363,1940,423,82.09902666102413,17.900973338975877,80,423,18.912529550827422
18097390200,"Census Tract 3902, Marion County, Indiana",2021,2103,1562,541,74.27484545886828,25.725154541131715,323,541,59.70425138632163
18097390300,"Census Tract 3903, Marion County, Indiana",2021,2161,1877,284,86.85793614067562,13.142063859324386,59,284,20.774647887323944
18097390405,"Census Tract 3904.05, Marion County, Indiana",2021,1907,838,1069,43.943366544310436,56.056633455689564,261,1069,24.41534144059869
18097390406,"Census Tract 3904.06, Marion County, Indiana",2021,1993,1878,115,94.22980431510285,5.77019568489714,43,115,37.391304347826086
18097390407,"Census Tract 3904.07, Marion County, Indiana",2021,2039,2011,28,98.62677783227072,1.373222167729279,0,28,0
18097390408,"Census Tract 3904.08, Marion County, Indiana",2021,1849,1821,28,98.48566792861006,1.5143320713899404,0,28,0
18097390409,"Census Tract 3904.09, Marion County, Indiana",2021,2852,2494,358,87.44740532959327,12.552594670406732,91,358,25.41899441340782
18097390410,"Census Tract 3904.10, Marion County, Indiana",2021,769,569,200,73.99219765929779,26.00780234070221,74,200,37
18097390411,"Census Tract 3904.11, Marion County, Indiana",2021,1572,981,591,62.404580152671755,37.595419847328245,363,591,61.421319796954315
18097390500,"Census Tract 3905, Marion County, Indiana",2021,996,509,487,51.10441767068273,48.89558232931727,239,487,49.07597535934291
18097390601,"Census Tract 3906.01, Marion County, Indiana",2021,891,104,787,11.672278338945006,88.327721661055,292,787,37.10292249047014
18097390602,"Census Tract 3906.02, Marion County, Indiana",2021,1858,417,1441,22.443487621097955,77.55651237890204,671,1441,46.56488549618321
18097390700,"Census Tract 3907, Marion County, Indiana",2021,1148,670,478,58.362369337979096,41.637630662020904,223,478,46.65271966527197
18097390801,"Census Tract 3908.01, Marion County, Indiana",2021,0,0,0,NA,NA,0,0,NA
18097390802,"Census Tract 3908.02, Marion County, Indiana",2021,1372,840,532,61.224489795918366,38.775510204081634,272,532,51.12781954887218
18097390900,"Census Tract 3909, Marion County, Indiana",2021,1510,671,839,44.437086092715234,55.562913907284766,451,839,53.75446960667461
18097391001,"Census Tract 3910.01, Marion County, Indiana",2021,479,52,427,10.855949895615867,89.14405010438414,125,427,29.27400468384075
18097391002,"Census Tract 3910.02, Marion County, Indiana",2021,3313,582,2731,17.56715967401147,82.43284032598854,806,2731,29.51299890150128
18097310104,Census Tract 3101.04; Marion County; Indiana,2022,1889,979,910,51.826363155108524,48.173636844891476,168,910,18.46153846153846
18097310105,Census Tract 3101.05; Marion County; Indiana,2022,1874,1010,864,53.89541088580577,46.10458911419423,559,864,64.69907407407408
18097310106,Census Tract 3101.06; Marion County; Indiana,2022,2273,284,1989,12.49450065992081,87.5054993400792,704,1989,35.39467068878834
18097310108,Census Tract 3101.08; Marion County; Indiana,2022,1629,1377,252,84.5303867403315,15.469613259668508,97,252,38.492063492063494
18097310110,Census Tract 3101.10; Marion County; Indiana,2022,1313,645,668,49.12414318354912,50.87585681645088,287,668,42.964071856287426
18097310111,Census Tract 3101.11; Marion County; Indiana,2022,1642,621,1021,37.81973203410475,62.18026796589525,400,1021,39.17727717923604
18097310112,Census Tract 3101.12; Marion County; Indiana,2022,2476,2285,191,92.2859450726979,7.7140549273021,40,191,20.94240837696335
18097310113,Census Tract 3101.13; Marion County; Indiana,2022,337,337,0,100,0,0,0,NA
18097310201,Census Tract 3102.01; Marion County; Indiana,2022,1547,1055,492,68.19650937297996,31.80349062702004,227,492,46.13821138211382
18097310203,Census Tract 3102.03; Marion County; Indiana,2022,2217,1172,1045,52.86423094271538,47.13576905728462,690,1045,66.02870813397129
18097310204,Census Tract 3102.04; Marion County; Indiana,2022,1739,1126,613,64.74985623921795,35.25014376078206,427,613,69.65742251223492
18097310305,Census Tract 3103.05; Marion County; Indiana,2022,2499,828,1671,33.13325330132053,66.86674669867948,617,1671,36.92399760622382
18097310306,Census Tract 3103.06; Marion County; Indiana,2022,2823,740,2083,26.213248317392843,73.78675168260716,626,2083,30.052808449351897
18097310308,Census Tract 3103.08; Marion County; Indiana,2022,1125,964,161,85.68888888888888,14.311111111111112,84,161,52.17391304347826
18097310309,Census Tract 3103.09; Marion County; Indiana,2022,1510,487,1023,32.25165562913907,67.74834437086092,437,1023,42.717497556207235
18097310310,Census Tract 3103.10; Marion County; Indiana,2022,1957,1471,486,75.16607051609607,24.833929483903933,321,486,66.04938271604938
18097310311,Census Tract 3103.11; Marion County; Indiana,2022,1889,1741,148,92.16516675489677,7.834833245103229,49,148,33.108108108108105
18097310312,Census Tract 3103.12; Marion County; Indiana,2022,2825,988,1837,34.97345132743363,65.02654867256638,1175,1837,63.96298312465977
18097320105,Census Tract 3201.05; Marion County; Indiana,2022,1867,965,902,51.68719871451526,48.31280128548474,313,902,34.70066518847007
18097320106,Census Tract 3201.06; Marion County; Indiana,2022,1340,550,790,41.04477611940298,58.95522388059702,340,790,43.037974683544306
18097320107,Census Tract 3201.07; Marion County; Indiana,2022,884,710,174,80.31674208144797,19.683257918552037,27,174,15.517241379310345
18097320108,Census Tract 3201.08; Marion County; Indiana,2022,2257,188,2069,8.329641116526362,91.67035888347364,1131,2069,54.66408893185113
18097320109,Census Tract 3201.09; Marion County; Indiana,2022,1346,1229,117,91.3075780089153,8.692421991084695,4,117,3.4188034188034186
18097320202,Census Tract 3202.02; Marion County; Indiana,2022,2487,1551,936,62.364294330518696,37.635705669481304,435,936,46.47435897435897
18097320203,Census Tract 3202.03; Marion County; Indiana,2022,1690,340,1350,20.118343195266274,79.88165680473372,676,1350,50.074074074074076
18097320205,Census Tract 3202.05; Marion County; Indiana,2022,1324,64,1260,4.833836858006042,95.16616314199396,392,1260,31.11111111111111
18097320206,Census Tract 3202.06; Marion County; Indiana,2022,1318,323,995,24.506828528072838,75.49317147192716,480,995,48.24120603015076
18097320301,Census Tract 3203.01; Marion County; Indiana,2022,1858,1568,290,84.39181916038751,15.608180839612487,116,290,40
18097320303,Census Tract 3203.03; Marion County; Indiana,2022,1725,11,1714,0.6376811594202898,99.3623188405797,839,1714,48.94982497082847
18097320305,Census Tract 3203.05; Marion County; Indiana,2022,1060,1002,58,94.52830188679245,5.471698113207547,32,58,55.172413793103445
18097320306,Census Tract 3203.06; Marion County; Indiana,2022,2289,974,1315,42.55133245958934,57.44866754041066,405,1315,30.79847908745247
18097320400,Census Tract 3204; Marion County; Indiana,2022,1476,704,772,47.696476964769644,52.303523035230356,316,772,40.932642487046635
18097320500,Census Tract 3205; Marion County; Indiana,2022,1402,721,681,51.426533523537806,48.573466476462194,457,681,67.1071953010279
18097320600,Census Tract 3206; Marion County; Indiana,2022,1050,766,284,72.95238095238095,27.047619047619047,95,284,33.45070422535211
18097320700,Census Tract 3207; Marion County; Indiana,2022,1222,744,478,60.88379705400982,39.11620294599018,166,478,34.72803347280335
18097320800,Census Tract 3208; Marion County; Indiana,2022,1199,1152,47,96.08006672226855,3.919933277731443,9,47,19.148936170212767
18097320901,Census Tract 3209.01; Marion County; Indiana,2022,2546,1737,809,68.22466614296937,31.775333857030635,529,809,65.389369592089
18097320902,Census Tract 3209.02; Marion County; Indiana,2022,1648,642,1006,38.95631067961165,61.04368932038835,650,1006,64.61232604373757
18097320903,Census Tract 3209.03; Marion County; Indiana,2022,2028,605,1423,29.83234714003945,70.16765285996055,847,1423,59.5221363316936
18097321001,Census Tract 3210.01; Marion County; Indiana,2022,1042,741,301,71.11324376199616,28.886756238003837,111,301,36.87707641196013
18097321002,Census Tract 3210.02; Marion County; Indiana,2022,1880,1498,382,79.68085106382979,20.319148936170212,232,382,60.73298429319372
18097321100,Census Tract 3211; Marion County; Indiana,2022,1540,1178,362,76.49350649350649,23.506493506493506,156,362,43.0939226519337
18097321200,Census Tract 3212; Marion County; Indiana,2022,1989,1541,448,77.47611865258924,22.52388134741076,149,448,33.25892857142857
18097321300,Census Tract 3213; Marion County; Indiana,2022,1367,795,572,58.15654718361375,41.84345281638625,216,572,37.76223776223776
18097321400,Census Tract 3214; Marion County; Indiana,2022,2530,1349,1181,53.3201581027668,46.6798418972332,349,1181,29.551227773073666
18097321600,Census Tract 3216; Marion County; Indiana,2022,2320,1334,986,57.5,42.5,567,986,57.505070993914806
18097321700,Census Tract 3217; Marion County; Indiana,2022,2065,1424,641,68.95883777239709,31.041162227602907,493,641,76.91107644305772
18097321800,Census Tract 3218; Marion County; Indiana,2022,1406,1154,252,82.07681365576103,17.923186344238974,119,252,47.22222222222222
18097321900,Census Tract 3219; Marion County; Indiana,2022,1248,1007,241,80.68910256410257,19.310897435897434,169,241,70.12448132780084
18097322000,Census Tract 3220; Marion County; Indiana,2022,1539,788,751,51.202079272254714,48.797920727745286,300,751,39.94673768308922
18097322100,Census Tract 3221; Marion County; Indiana,2022,915,735,180,80.32786885245902,19.672131147540984,63,180,35
18097322200,Census Tract 3222; Marion County; Indiana,2022,880,653,227,74.20454545454545,25.795454545454547,75,227,33.03964757709251
18097322300,Census Tract 3223; Marion County; Indiana,2022,961,620,341,64.51612903225806,35.483870967741936,38,341,11.143695014662757
18097322400,Census Tract 3224; Marion County; Indiana,2022,1570,908,662,57.8343949044586,42.1656050955414,334,662,50.453172205438065
18097322500,Census Tract 3225; Marion County; Indiana,2022,777,178,599,22.90862290862291,77.0913770913771,320,599,53.42237061769616
18097322601,Census Tract 3226.01; Marion County; Indiana,2022,943,129,814,13.679745493107106,86.3202545068929,352,814,43.24324324324324
18097322602,Census Tract 3226.02; Marion County; Indiana,2022,809,243,566,30.03708281829419,69.9629171817058,182,566,32.15547703180212
18097322700,Census Tract 3227; Marion County; Indiana,2022,888,704,184,79.27927927927928,20.72072072072072,49,184,26.630434782608695
18097330103,Census Tract 3301.03; Marion County; Indiana,2022,2182,1190,992,54.53712190650779,45.46287809349221,465,992,46.875
18097330105,Census Tract 3301.05; Marion County; Indiana,2022,2375,728,1647,30.652631578947368,69.34736842105264,523,1647,31.754705525197327
18097330106,Census Tract 3301.06; Marion County; Indiana,2022,2300,472,1828,20.52173913043478,79.47826086956522,888,1828,48.57768052516411
18097330107,Census Tract 3301.07; Marion County; Indiana,2022,2284,2222,62,97.28546409807356,2.714535901926445,0,62,0
18097330108,Census Tract 3301.08; Marion County; Indiana,2022,1623,1490,133,91.80529882932841,8.194701170671596,0,133,0
18097330109,Census Tract 3301.09; Marion County; Indiana,2022,2055,1920,135,93.43065693430657,6.569343065693431,38,135,28.14814814814815
18097330203,Census Tract 3302.03; Marion County; Indiana,2022,1868,1801,67,96.41327623126338,3.5867237687366167,33,67,49.25373134328358
18097330204,Census Tract 3302.04; Marion County; Indiana,2022,2168,2131,37,98.29335793357933,1.7066420664206643,37,37,100
18097330206,Census Tract 3302.06; Marion County; Indiana,2022,1821,1711,110,93.95936298736957,6.040637012630423,35,110,31.818181818181817
18097330208,Census Tract 3302.08; Marion County; Indiana,2022,1271,1043,228,82.06136900078678,17.938630999213217,115,228,50.43859649122807
18097330210,Census Tract 3302.10; Marion County; Indiana,2022,2158,1779,379,82.43744207599629,17.562557924003706,127,379,33.50923482849604
18097330211,Census Tract 3302.11; Marion County; Indiana,2022,1822,654,1168,35.89462129527991,64.10537870472008,733,1168,62.75684931506849
18097330212,Census Tract 3302.12; Marion County; Indiana,2022,1769,1458,311,82.41944601469757,17.58055398530243,78,311,25.080385852090032
18097330213,Census Tract 3302.13; Marion County; Indiana,2022,1519,1106,413,72.8110599078341,27.1889400921659,60,413,14.527845036319613
18097330401,Census Tract 3304.01; Marion County; Indiana,2022,2224,1632,592,73.38129496402878,26.618705035971225,320,592,54.054054054054056
18097330500,Census Tract 3305; Marion County; Indiana,2022,2614,2102,512,80.41315990818669,19.58684009181331,332,512,64.84375
18097330600,Census Tract 3306; Marion County; Indiana,2022,2402,957,1445,39.84179850124896,60.15820149875104,975,1445,67.47404844290658
18097330701,Census Tract 3307.01; Marion County; Indiana,2022,986,410,576,41.58215010141988,58.41784989858012,329,576,57.11805555555556
18097330702,Census Tract 3307.02; Marion County; Indiana,2022,1504,1089,415,72.40691489361703,27.59308510638298,271,415,65.3012048192771
18097330803,Census Tract 3308.03; Marion County; Indiana,2022,1512,346,1166,22.883597883597883,77.11640211640211,466,1166,39.96569468267582
18097330804,Census Tract 3308.04; Marion County; Indiana,2022,1289,428,861,33.20403413498836,66.79596586501164,350,861,40.65040650406504
18097330805,Census Tract 3308.05; Marion County; Indiana,2022,1017,294,723,28.908554572271388,71.09144542772862,363,723,50.20746887966805
18097330806,Census Tract 3308.06; Marion County; Indiana,2022,1440,516,924,35.833333333333336,64.16666666666667,542,924,58.65800865800866
18097330900,Census Tract 3309; Marion County; Indiana,2022,2888,811,2077,28.081717451523545,71.91828254847645,1034,2077,49.783341357727494
18097331000,Census Tract 3310; Marion County; Indiana,2022,1611,788,823,48.91371818746121,51.08628181253879,651,823,79.10085054678007
18097340101,Census Tract 3401.01; Marion County; Indiana,2022,1980,1674,306,84.54545454545455,15.454545454545455,79,306,25.81699346405229
18097340102,Census Tract 3401.02; Marion County; Indiana,2022,1818,317,1501,17.436743674367438,82.56325632563257,870,1501,57.961359093937375
18097340108,Census Tract 3401.08; Marion County; Indiana,2022,1278,162,1116,12.67605633802817,87.32394366197182,405,1116,36.29032258064516
18097340111,Census Tract 3401.11; Marion County; Indiana,2022,959,794,165,82.79457768508864,17.205422314911367,107,165,64.84848484848484
18097340112,Census Tract 3401.12; Marion County; Indiana,2022,2277,1179,1098,51.77865612648221,48.22134387351779,604,1098,55.00910746812386
18097340113,Census Tract 3401.13; Marion County; Indiana,2022,1663,1033,630,62.11665664461816,37.88334335538184,434,630,68.88888888888889
18097340114,Census Tract 3401.14; Marion County; Indiana,2022,1690,1296,394,76.68639053254438,23.31360946745562,119,394,30.20304568527919
18097340115,Census Tract 3401.15; Marion County; Indiana,2022,2896,612,2284,21.132596685082873,78.86740331491713,862,2284,37.74080560420315
18097340201,Census Tract 3402.01; Marion County; Indiana,2022,1173,764,409,65.13213981244672,34.86786018755328,174,409,42.54278728606357
18097340202,Census Tract 3402.02; Marion County; Indiana,2022,1889,650,1239,34.409740603493916,65.59025939650608,552,1239,44.55205811138015
18097340301,Census Tract 3403.01; Marion County; Indiana,2022,1039,458,581,44.08084696823869,55.91915303176131,325,581,55.93803786574871
18097340302,Census Tract 3403.02; Marion County; Indiana,2022,1713,627,1086,36.60245183887916,63.39754816112084,449,1086,41.34438305709024
18097340400,Census Tract 3404; Marion County; Indiana,2022,1373,784,589,57.10123816460306,42.89876183539694,313,589,53.140916808149406
18097340500,Census Tract 3405; Marion County; Indiana,2022,2083,413,1670,19.827172347575612,80.17282765242439,979,1670,58.622754491017965
18097340600,Census Tract 3406; Marion County; Indiana,2022,1778,957,821,53.82452193475815,46.17547806524185,361,821,43.97076735688185
18097340700,Census Tract 3407; Marion County; Indiana,2022,1490,559,931,37.51677852348993,62.48322147651007,512,931,54.994629430719655
18097340800,Census Tract 3408; Marion County; Indiana,2022,771,606,165,78.59922178988327,21.40077821011673,51,165,30.90909090909091
18097340901,Census Tract 3409.01; Marion County; Indiana,2022,1278,1181,97,92.41001564945226,7.589984350547731,43,97,44.329896907216494
18097340903,Census Tract 3409.03; Marion County; Indiana,2022,1103,141,962,12.783318223028106,87.2166817769719,394,962,40.95634095634096
18097340904,Census Tract 3409.04; Marion County; Indiana,2022,2351,803,1548,34.15567843470863,65.84432156529137,563,1548,36.36950904392765
18097341000,Census Tract 3410; Marion County; Indiana,2022,787,632,155,80.30495552731894,19.69504447268107,88,155,56.774193548387096
18097341100,Census Tract 3411; Marion County; Indiana,2022,771,344,427,44.617380025940335,55.382619974059665,191,427,44.730679156908664
18097341200,Census Tract 3412; Marion County; Indiana,2022,783,461,322,58.876117496807154,41.123882503192846,199,322,61.80124223602485
18097341600,Census Tract 3416; Marion County; Indiana,2022,871,379,492,43.51320321469575,56.48679678530425,325,492,66.0569105691057
18097341701,Census Tract 3417.01; Marion County; Indiana,2022,833,537,296,64.46578631452581,35.53421368547419,202,296,68.24324324324324
18097341702,Census Tract 3417.02; Marion County; Indiana,2022,839,419,420,49.9404052443385,50.0595947556615,232,420,55.23809523809524
18097341902,Census Tract 3419.02; Marion County; Indiana,2022,1639,1348,291,82.24527150701647,17.754728492983528,122,291,41.92439862542955
18097341903,Census Tract 3419.03; Marion County; Indiana,2022,2125,411,1714,19.341176470588234,80.65882352941176,750,1714,43.75729288214703
18097341904,Census Tract 3419.04; Marion County; Indiana,2022,957,341,616,35.632183908045974,64.36781609195403,326,616,52.922077922077925
18097342000,Census Tract 3420; Marion County; Indiana,2022,2059,1690,369,82.07867897037397,17.921321029626032,105,369,28.45528455284553
18097342101,Census Tract 3421.01; Marion County; Indiana,2022,2092,1303,789,62.2848948374761,37.7151051625239,292,789,37.00887198986058
18097342200,Census Tract 3422; Marion County; Indiana,2022,1845,1094,751,59.295392953929536,40.704607046070464,293,751,39.01464713715047
18097342300,Census Tract 3423; Marion County; Indiana,2022,2322,1418,904,61.06804478897502,38.93195521102498,328,904,36.283185840707965
18097342400,Census Tract 3424; Marion County; Indiana,2022,508,307,201,60.43307086614173,39.56692913385827,83,201,41.29353233830846
18097342500,Census Tract 3425; Marion County; Indiana,2022,1717,974,743,56.726849155503785,43.273150844496215,382,743,51.41318977119785
18097342600,Census Tract 3426; Marion County; Indiana,2022,1163,552,611,47.46345657781599,52.53654342218401,242,611,39.60720130932897
18097350100,Census Tract 3501; Marion County; Indiana,2022,611,416,195,68.08510638297872,31.914893617021278,67,195,34.35897435897436
18097350300,Census Tract 3503; Marion County; Indiana,2022,1572,237,1335,15.076335877862595,84.92366412213741,768,1335,57.52808988764045
18097350400,Census Tract 3504; Marion County; Indiana,2022,1101,550,551,49.95458673932789,50.04541326067211,240,551,43.55716878402904
18097350500,Census Tract 3505; Marion County; Indiana,2022,1040,589,451,56.63461538461539,43.36538461538461,183,451,40.57649667405765
18097350600,Census Tract 3506; Marion County; Indiana,2022,2396,1404,992,58.59766277128548,41.40233722871452,766,992,77.21774193548387
18097350700,Census Tract 3507; Marion County; Indiana,2022,751,273,478,36.35153129161119,63.64846870838881,327,478,68.41004184100419
18097350800,Census Tract 3508; Marion County; Indiana,2022,846,278,568,32.860520094562645,67.139479905437355,293,568,51.58450704225352
18097350900,Census Tract 3509; Marion County; Indiana,2022,697,391,306,56.09756097560975,43.90243902439025,181,306,59.150326797385624
18097351000,Census Tract 3510; Marion County; Indiana,2022,1018,644,374,63.26129666011788,36.73870333988212,199,374,53.20855614973262
18097351200,Census Tract 3512; Marion County; Indiana,2022,1132,471,661,41.6077738515901,58.3922261484099,393,661,59.4553706505295
18097351500,Census Tract 3515; Marion County; Indiana,2022,993,315,678,31.722054380664652,68.27794561933534,352,678,51.91740412979351
18097351600,Census Tract 3516; Marion County; Indiana,2022,1224,750,474,61.27450980392157,38.72549019607843,144,474,30.379746835443036
18097351700,Census Tract 3517; Marion County; Indiana,2022,1140,763,377,66.9298245614035,33.07017543859649,161,377,42.705570291777185
18097351900,Census Tract 3519; Marion County; Indiana,2022,1018,562,456,55.20628683693517,44.79371316306483,263,456,57.675438596491226
18097352100,Census Tract 3521; Marion County; Indiana,2022,741,325,416,43.85964912280702,56.14035087719298,237,416,56.97115384615385
18097352300,Census Tract 3523; Marion County; Indiana,2022,570,213,357,37.36842105263158,62.63157894736842,191,357,53.50140056022409
18097352400,Census Tract 3524; Marion County; Indiana,2022,1297,491,806,37.85659213569777,62.14340786430223,406,806,50.37220843672456
18097352500,Census Tract 3525; Marion County; Indiana,2022,1666,858,808,51.50060024009604,48.49939975990396,470,808,58.16831683168317
18097352600,Census Tract 3526; Marion County; Indiana,2022,1436,666,770,46.37883008356546,53.62116991643454,503,770,65.32467532467533
18097352700,Census Tract 3527; Marion County; Indiana,2022,945,620,325,65.60846560846561,34.39153439153439,200,325,61.53846153846154
18097352800,Census Tract 3528; Marion County; Indiana,2022,618,152,466,24.59546925566343,75.40453074433657,192,466,41.201716738197426
18097353300,Census Tract 3533; Marion County; Indiana,2022,1493,337,1156,22.572002679169458,77.42799732083054,595,1156,51.470588235294116
18097353500,Census Tract 3535; Marion County; Indiana,2022,1241,184,1057,14.826752618855762,85.17324738114424,668,1057,63.19772942289499
18097353600,Census Tract 3536; Marion County; Indiana,2022,1214,408,806,33.60790774299835,66.39209225700165,352,806,43.67245657568238
18097354201,Census Tract 3542.01; Marion County; Indiana,2022,2612,783,1829,29.977029096477796,70.02297090352221,749,1829,40.95133952979771
18097354202,Census Tract 3542.02; Marion County; Indiana,2022,2309,644,1665,27.890861844954525,72.10913815504547,627,1665,37.65765765765766
18097354400,Census Tract 3544; Marion County; Indiana,2022,716,487,229,68.01675977653632,31.98324022346369,99,229,43.23144104803494
18097354500,Census Tract 3545; Marion County; Indiana,2022,917,385,532,41.98473282442748,58.01526717557252,175,532,32.89473684210526
18097354700,Census Tract 3547; Marion County; Indiana,2022,677,296,381,43.72230428360414,56.27769571639586,159,381,41.732283464566926
18097354800,Census Tract 3548; Marion County; Indiana,2022,609,392,217,64.36781609195403,35.632183908045974,92,217,42.3963133640553
18097354900,Census Tract 3549; Marion County; Indiana,2022,1328,388,940,29.216867469879517,70.78313253012048,460,940,48.93617021276596
18097355000,Census Tract 3550; Marion County; Indiana,2022,762,429,333,56.2992125984252,43.7007874015748,145,333,43.54354354354354
18097355100,Census Tract 3551; Marion County; Indiana,2022,976,204,772,20.901639344262296,79.09836065573771,546,772,70.72538860103627
18097355300,Census Tract 3553; Marion County; Indiana,2022,1179,375,804,31.806615776081426,68.19338422391857,457,804,56.840796019900495
18097355400,Census Tract 3554; Marion County; Indiana,2022,1247,543,704,43.54450681635926,56.45549318364074,306,704,43.46590909090909
18097355500,Census Tract 3555; Marion County; Indiana,2022,1451,911,540,62.784286698828396,37.215713301171604,128,540,23.703703703703702
18097355600,Census Tract 3556; Marion County; Indiana,2022,891,420,471,47.138047138047135,52.861952861952865,254,471,53.92781316348195
18097355700,Census Tract 3557; Marion County; Indiana,2022,986,536,450,54.36105476673428,45.63894523326572,199,450,44.22222222222222
18097355900,Census Tract 3559; Marion County; Indiana,2022,1002,614,388,61.27744510978044,38.72255489021956,167,388,43.04123711340206
18097356200,Census Tract 3562; Marion County; Indiana,2022,1221,289,932,23.669123669123667,76.33087633087634,215,932,23.068669527896997
18097356400,Census Tract 3564; Marion County; Indiana,2022,1718,494,1224,28.754365541327125,71.24563445867288,585,1224,47.794117647058826
18097356900,Census Tract 3569; Marion County; Indiana,2022,853,516,337,60.492379835873386,39.507620164126614,168,337,49.85163204747774
18097357000,Census Tract 3570; Marion County; Indiana,2022,826,520,306,62.95399515738499,37.04600484261501,214,306,69.93464052287581
18097357100,Census Tract 3571; Marion County; Indiana,2022,926,560,366,60.475161987041034,39.524838012958966,136,366,37.15846994535519
18097357200,Census Tract 3572; Marion County; Indiana,2022,915,609,306,66.55737704918033,33.442622950819676,107,306,34.967320261437905
18097357300,Census Tract 3573; Marion County; Indiana,2022,922,285,637,30.911062906724514,69.08893709327549,401,637,62.95133437990581
18097357400,Census Tract 3574; Marion County; Indiana,2022,1711,835,876,48.80187025131502,51.19812974868498,464,876,52.96803652968037
18097357500,Census Tract 3575; Marion County; Indiana,2022,1248,944,304,75.64102564102564,24.358974358974358,175,304,57.56578947368421
18097357601,Census Tract 3576.01; Marion County; Indiana,2022,1747,910,837,52.0892959358901,47.9107040641099,510,837,60.93189964157706
18097357602,Census Tract 3576.02; Marion County; Indiana,2022,442,295,147,66.7420814479638,33.2579185520362,66,147,44.89795918367347
18097357800,Census Tract 3578; Marion County; Indiana,2022,647,293,354,45.28593508500773,54.71406491499227,234,354,66.10169491525424
18097357900,Census Tract 3579; Marion County; Indiana,2022,1396,815,581,58.3810888252149,41.6189111747851,353,581,60.75731497418244
18097358000,Census Tract 3580; Marion County; Indiana,2022,491,282,209,57.43380855397149,42.56619144602851,150,209,71.77033492822966
18097358100,Census Tract 3581; Marion County; Indiana,2022,979,671,308,68.53932584269663,31.46067415730337,169,308,54.87012987012987
18097360101,Census Tract 3601.01; Marion County; Indiana,2022,1136,409,727,36.00352112676056,63.99647887323944,367,727,50.48143053645117
18097360102,Census Tract 3601.02; Marion County; Indiana,2022,956,479,477,50.10460251046025,49.89539748953975,250,477,52.41090146750524
18097360201,Census Tract 3602.01; Marion County; Indiana,2022,1979,516,1463,26.07377463365336,73.92622536634664,837,1463,57.21120984278879
18097360202,Census Tract 3602.02; Marion County; Indiana,2022,1091,672,419,61.5948670944088,38.4051329055912,209,419,49.88066825775656
18097360301,Census Tract 3603.01; Marion County; Indiana,2022,1289,700,589,54.30566330488751,45.69433669511249,389,589,66.04414261460101
18097360302,Census Tract 3603.02; Marion County; Indiana,2022,1034,360,674,34.81624758220503,65.18375241779498,473,674,70.17804154302671
18097360401,Census Tract 3604.01; Marion County; Indiana,2022,2698,470,2228,17.420311341734617,82.57968865826538,855,2228,38.37522441651706
18097360402,Census Tract 3604.02; Marion County; Indiana,2022,1103,461,642,41.795104261106076,58.204895738893924,497,642,77.41433021806854
18097360405,Census Tract 3604.05; Marion County; Indiana,2022,2558,1620,938,63.33072713057076,36.66927286942924,418,938,44.562899786780385
18097360406,Census Tract 3604.06; Marion County; Indiana,2022,1569,462,1107,29.445506692160613,70.5544933078394,585,1107,52.84552845528455
18097360407,Census Tract 3604.07; Marion County; Indiana,2022,1239,678,561,54.72154963680387,45.27845036319613,277,561,49.376114081996434
18097360501,Census Tract 3605.01; Marion County; Indiana,2022,2395,1698,697,70.89770354906054,29.102296450939455,321,697,46.0545193687231
18097360502,Census Tract 3605.02; Marion County; Indiana,2022,2090,1610,480,77.03349282296651,22.966507177033492,357,480,74.375
18097360601,Census Tract 3606.01; Marion County; Indiana,2022,1889,1497,392,79.24827951296983,20.751720487030173,222,392,56.63265306122449
18097360602,Census Tract 3606.02; Marion County; Indiana,2022,2473,1137,1336,45.9765467044076,54.0234532955924,874,1336,65.41916167664671
18097360700,Census Tract 3607; Marion County; Indiana,2022,856,728,128,85.04672897196262,14.953271028037383,81,128,63.28125
18097360800,Census Tract 3608; Marion County; Indiana,2022,1222,356,866,29.132569558101473,70.86743044189852,482,866,55.65819861431871
18097360900,Census Tract 3609; Marion County; Indiana,2022,2372,1384,988,58.34738617200674,41.65261382799326,541,988,54.75708502024292
18097361000,Census Tract 3610; Marion County; Indiana,2022,1021,923,98,90.40156709108717,9.59843290891283,39,98,39.795918367346935
18097361100,Census Tract 3611; Marion County; Indiana,2022,1567,932,635,59.47670708359924,40.52329291640076,315,635,49.60629921259842
18097361200,Census Tract 3612; Marion County; Indiana,2022,1419,765,654,53.911205073995774,46.088794926004226,207,654,31.65137614678899
18097361300,Census Tract 3613; Marion County; Indiana,2022,1080,851,229,78.79629629629629,21.203703703703702,44,229,19.213973799126638
18097361401,Census Tract 3614.01; Marion County; Indiana,2022,1923,1334,589,69.37077483099324,30.62922516900676,354,589,60.101867572156195
18097361402,Census Tract 3614.02; Marion County; Indiana,2022,2043,1310,733,64.12139011257953,35.87860988742046,231,733,31.51432469304229
18097361601,Census Tract 3616.01; Marion County; Indiana,2022,2014,1914,100,95.03475670307846,4.965243296921549,86,100,86
18097361602,Census Tract 3616.02; Marion County; Indiana,2022,1268,1222,46,96.37223974763407,3.6277602523659307,0,46,0
18097370201,Census Tract 3702.01; Marion County; Indiana,2022,1345,713,632,53.01115241635688,46.98884758364312,308,632,48.734177215189874
18097370203,Census Tract 3702.03; Marion County; Indiana,2022,1500,686,814,45.733333333333334,54.266666666666666,472,814,57.98525798525799
18097370204,Census Tract 3702.04; Marion County; Indiana,2022,1481,869,612,58.67656988521269,41.32343011478731,363,612,59.31372549019608
18097370303,Census Tract 3703.03; Marion County; Indiana,2022,2385,1775,610,74.42348008385744,25.57651991614256,258,610,42.295081967213115
18097370304,Census Tract 3703.04; Marion County; Indiana,2022,1366,1125,241,82.35724743777452,17.642752562225475,74,241,30.70539419087137
18097370305,Census Tract 3703.05; Marion County; Indiana,2022,1801,559,1242,31.038312048861744,68.96168795113826,946,1242,76.16747181964573
18097370306,Census Tract 3703.06; Marion County; Indiana,2022,2040,1773,267,86.91176470588235,13.088235294117647,43,267,16.10486891385768
18097380101,Census Tract 3801.01; Marion County; Indiana,2022,2963,2559,404,86.36517043536956,13.634829564630442,161,404,39.851485148514854
18097380102,Census Tract 3801.02; Marion County; Indiana,2022,1353,838,515,61.936437546193645,38.063562453806355,44,515,8.54368932038835
18097380103,Census Tract 3801.03; Marion County; Indiana,2022,3011,2027,984,67.31982729990037,32.68017270009963,485,984,49.28861788617886
18097380200,Census Tract 3802; Marion County; Indiana,2022,1587,715,872,45.05356017643352,54.94643982356648,624,872,71.55963302752293
18097380301,Census Tract 3803.01; Marion County; Indiana,2022,767,522,245,68.0573663624511,31.94263363754889,223,245,91.0204081632653
18097380302,Census Tract 3803.02; Marion County; Indiana,2022,872,295,577,33.830275229357795,66.1697247706422,339,577,58.752166377816295
18097380402,Census Tract 3804.02; Marion County; Indiana,2022,2160,709,1451,32.824074074074076,67.17592592592592,658,1451,45.34803583735355
18097380403,Census Tract 3804.03; Marion County; Indiana,2022,1501,1111,390,74.017321785476355,25.982678214523652,109,390,27.94871794871795
18097380404,Census Tract 3804.04; Marion County; Indiana,2022,1613,1219,394,75.57346559206448,24.426534407935524,235,394,59.64467005076142
18097380501,Census Tract 3805.01; Marion County; Indiana,2022,914,551,363,60.284463894967175,39.715536105032825,230,363,63.36088154269972
18097380502,Census Tract 3805.02; Marion County; Indiana,2022,1639,550,1089,33.557046979865774,66.44295302013423,709,1089,65.10560146923784
18097380600,Census Tract 3806; Marion County; Indiana,2022,2114,1015,1099,48.01324503311258,51.98675496688742,519,1099,47.224749772520475
18097380700,Census Tract 3807; Marion County; Indiana,2022,2595,1329,1266,51.213872832369944,48.786127167630056,899,1266,71.01105845181675
18097380800,Census Tract 3808; Marion County; Indiana,2022,1228,824,404,67.10097719869707,32.899022801302934,207,404,51.23762376237624
18097380901,Census Tract 3809.01; Marion County; Indiana,2022,1954,1839,115,94.11463664278403,5.885363357215967,0,115,0
18097380902,Census Tract 3809.02; Marion County; Indiana,2022,2602,1736,866,66.71790930053805,33.28209069946195,296,866,34.18013856812933
18097381002,Census Tract 3810.02; Marion County; Indiana,2022,1425,1287,138,90.3157894736842,9.68421052631579,73,138,52.89855072463768
18097381003,Census Tract 3810.03; Marion County; Indiana,2022,1527,636,891,41.650294695481335,58.349705304518665,433,891,48.597081930415264
18097381004,Census Tract 3810.04; Marion County; Indiana,2022,1512,276,1236,18.253968253968253,81.74603174603175,665,1236,53.80258899676375
18097381101,Census Tract 3811.01; Marion County; Indiana,2022,2496,1594,902,63.86217948717949,36.13782051282051,403,902,44.67849223946785
18097381102,Census Tract 3811.02; Marion County; Indiana,2022,2716,2251,465,82.87923416789396,17.120765832106038,193,465,41.505376344086024
18097381203,Census Tract 3812.03; Marion County; Indiana,2022,1119,293,826,26.18409294012511,73.81590705987489,513,826,62.106537530266344
18097381204,Census Tract 3812.04; Marion County; Indiana,2022,1525,145,1380,9.508196721311476,90.49180327868852,867,1380,62.82608695652174
18097381205,Census Tract 3812.05; Marion County; Indiana,2022,2549,1040,1509,40.80031384856807,59.19968615143193,551,1509,36.5142478462558
18097381206,Census Tract 3812.06; Marion County; Indiana,2022,1810,918,892,50.71823204419889,49.28176795580111,210,892,23.542600896860986
18097381207,Census Tract 3812.07; Marion County; Indiana,2022,1534,1496,38,97.52281616688397,2.4771838331160363,0,38,0
18097390102,Census Tract 3901.02; Marion County; Indiana,2022,2646,991,1655,37.45275888133031,62.54724111866969,1034,1655,62.477341389728096
18097390103,Census Tract 3901.03; Marion County; Indiana,2022,1291,1138,153,88.14872192099148,11.851278079008521,71,153,46.40522875816993
18097390104,Census Tract 3901.04; Marion County; Indiana,2022,2433,2076,357,85.32675709001234,14.67324290998767,93,357,26.050420168067227
18097390200,Census Tract 3902; Marion County; Indiana,2022,2178,1813,365,83.2415059687787,16.758494031221304,141,365,38.63013698630137
18097390300,Census Tract 3903; Marion County; Indiana,2022,2255,2046,209,90.73170731707317,9.268292682926829,57,209,27.272727272727273
18097390405,Census Tract 3904.05; Marion County; Indiana,2022,2006,809,1197,40.32901296111665,59.67098703888335,325,1197,27.151211361737676
18097390406,Census Tract 3904.06; Marion County; Indiana,2022,2048,1906,142,93.06640625,6.93359375,47,142,33.098591549295776
18097390407,Census Tract 3904.07; Marion County; Indiana,2022,2072,2057,15,99.27606177606178,0.7239382239382239,0,15,0
18097390408,Census Tract 3904.08; Marion County; Indiana,2022,1837,1760,77,95.80838323353294,4.191616766467066,0,77,0
18097390409,Census Tract 3904.09; Marion County; Indiana,2022,2851,2437,414,85.47877937565767,14.521220624342336,113,414,27.294685990338163
18097390410,Census Tract 3904.10; Marion County; Indiana,2022,771,565,206,73.28145265888456,26.718547341115436,52,206,25.24271844660194
18097390411,Census Tract 3904.11; Marion County; Indiana,2022,1624,1091,533,67.17980295566502,32.820197044334975,310,533,58.16135084427767
18097390500,Census Tract 3905; Marion County; Indiana,2022,1124,569,555,50.62277580071174,49.37722419928826,271,555,48.828828828828826
18097390601,Census Tract 3906.01; Marion County; Indiana,2022,991,75,916,7.568113017154389,92.43188698284561,381,916,41.5938864628821
18097390602,Census Tract 3906.02; Marion County; Indiana,2022,1922,404,1518,21.019771071800207,78.980228928199793,667,1518,43.93939393939394
18097390700,Census Tract 3907; Marion County; Indiana,2022,1190,772,418,64.87394957983193,35.12605042016807,189,418,45.21531100478469
18097390801,Census Tract 3908.01; Marion County; Indiana,2022,0,0,0,NA,NA,0,0,NA
18097390802,Census Tract 3908.02; Marion County; Indiana,2022,1509,841,668,55.73227302849569,44.26772697150431,412,668,61.67664670658683
18097390900,Census Tract 3909; Marion County; Indiana,2022,1525,675,850,44.26229508196721,55.73770491803279,403,850,47.411764705882355
18097391001,Census Tract 3910.01; Marion County; Indiana,2022,447,14,433,3.131991051454139,96.86800894854586,155,433,35.79676674364896
18097391002,Census Tract 3910.02; Marion County; Indiana,2022,3501,507,2994,14.481576692373608,85.51842330762639,950,2994,31.730126920507683
18097310104,Census Tract 3101.04; Marion County; Indiana,2023,1926,892,1034,46.31360332294912,53.68639667705088,341,1034,32.97872340425532
18097310105,Census Tract 3101.05; Marion County; Indiana,2023,1907,1071,836,56.16151022548505,43.83848977451495,586,836,70.09569377990431
18097310106,Census Tract 3101.06; Marion County; Indiana,2023,2310,212,2098,9.177489177489177,90.82251082251082,745,2098,35.51000953288847
18097310108,Census Tract 3101.08; Marion County; Indiana,2023,1622,1389,233,85.635018495684335,14.36498150431566,103,233,44.20600858369099
18097310110,Census Tract 3101.10; Marion County; Indiana,2023,1319,738,581,55.95147839272176,44.04852160727824,231,581,39.75903614457831
18097310111,Census Tract 3101.11; Marion County; Indiana,2023,1526,669,857,43.840104849279165,56.159895150720835,326,857,38.03967327887981
18097310112,Census Tract 3101.12; Marion County; Indiana,2023,2451,2333,118,95.18563851489188,4.814361485108119,40,118,33.898305084745765
18097310113,Census Tract 3101.13; Marion County; Indiana,2023,372,372,0,100,0,0,0,NA
18097310201,Census Tract 3102.01; Marion County; Indiana,2023,1667,1054,613,63.22735452909418,36.77264547090582,301,613,49.10277324632953
18097310203,Census Tract 3102.03; Marion County; Indiana,2023,2134,1138,996,53.32708528584817,46.67291471415183,650,996,65.26104417670683
18097310204,Census Tract 3102.04; Marion County; Indiana,2023,1765,1159,606,65.6657223796034,34.3342776203966,380,606,62.70627062706271
18097310305,Census Tract 3103.05; Marion County; Indiana,2023,2629,786,1843,29.8972993533663,70.1027006466337,716,1843,38.84970157352143
18097310306,Census Tract 3103.06; Marion County; Indiana,2023,3045,880,2165,28.89983579638752,71.10016420361248,720,2165,33.25635103926097
18097310308,Census Tract 3103.08; Marion County; Indiana,2023,1235,996,239,80.64777327935222,19.352226720647774,98,239,41.004184100418414
18097310309,Census Tract 3103.09; Marion County; Indiana,2023,1586,598,988,37.704918032786885,62.295081967213115,345,988,34.91902834008097
18097310310,Census Tract 3103.10; Marion County; Indiana,2023,2013,1495,518,74.26726279185296,25.732737208147043,320,518,61.77606177606177
18097310311,Census Tract 3103.11; Marion County; Indiana,2023,1877,1791,86,95.41822056473096,4.581779435269047,19,86,22.093023255813954
18097310312,Census Tract 3103.12; Marion County; Indiana,2023,2907,1259,1648,43.30925352597179,56.69074647402821,948,1648,57.52427184466019
18097320105,Census Tract 3201.05; Marion County; Indiana,2023,1911,1019,892,53.322867608581895,46.677132391418105,250,892,28.026905829596412
18097320106,Census Tract 3201.06; Marion County; Indiana,2023,1374,551,823,40.1018922852984,59.8981077147016,298,823,36.2089914945322
18097320107,Census Tract 3201.07; Marion County; Indiana,2023,868,714,154,82.25806451612904,17.741935483870968,17,154,11.03896103896104
18097320108,Census Tract 3201.08; Marion County; Indiana,2023,2198,303,1895,13.7852593266606,86.2147406733394,1030,1895,54.35356200527705
18097320109,Census Tract 3201.09; Marion County; Indiana,2023,1354,1201,153,88.70014771048744,11.299852289512556,20,153,13.071895424836601
18097320202,Census Tract 3202.02; Marion County; Indiana,2023,2488,1541,947,61.937299035369776,38.062700964630224,528,947,55.75501583949313
18097320203,Census Tract 3202.03; Marion County; Indiana,2023,1756,375,1381,21.355353075170843,78.64464692482916,635,1381,45.981173062997826
18097320205,Census Tract 3202.05; Marion County; Indiana,2023,1294,97,1197,7.496136012364761,92.50386398763524,303,1197,25.31328320802005
18097320206,Census Tract 3202.06; Marion County; Indiana,2023,1312,259,1053,19.740853658536587,80.25914634146342,528,1053,50.142450142450144
18097320301,Census Tract 3203.01; Marion County; Indiana,2023,1847,1506,341,81.53762858689767,18.46237141310233,142,341,41.64222873900293
18097320303,Census Tract 3203.03; Marion County; Indiana,2023,1918,0,1918,0,100,826,1918,43.065693430656935
18097320305,Census Tract 3203.05; Marion County; Indiana,2023,1052,962,90,91.4448669201521,8.55513307984791,48,90,53.333333333333336
18097320306,Census Tract 3203.06; Marion County; Indiana,2023,2301,983,1318,42.720556279878316,57.279443720121684,520,1318,39.45371775417299
18097320400,Census Tract 3204; Marion County; Indiana,2023,1409,733,676,52.022711142654366,47.977288857345634,367,676,54.289940828402365
18097320500,Census Tract 3205; Marion County; Indiana,2023,1436,765,671,53.27298050139276,46.72701949860724,442,671,65.87183308494784
18097320600,Census Tract 3206; Marion County; Indiana,2023,1033,753,280,72.8944820909971,27.105517909002906,100,280,35.714285714285715
18097320700,Census Tract 3207; Marion County; Indiana,2023,1239,699,540,56.416464891041166,43.583535108958834,196,540,36.2962962962963
18097320800,Census Tract 3208; Marion County; Indiana,2023,1173,1106,67,94.28815004262574,5.711849957374254,15,67,22.388059701492537
18097320901,Census Tract 3209.01; Marion County; Indiana,2023,2608,1842,766,70.62883435582822,29.37116564417178,450,766,58.746736292428196
18097320902,Census Tract 3209.02; Marion County; Indiana,2023,1764,694,1070,39.342403628117914,60.657596371882086,663,1070,61.96261682242991
18097320903,Census Tract 3209.03; Marion County; Indiana,2023,1990,706,1284,35.47738693467337,64.52261306532664,738,1284,57.47663551401869
18097321001,Census Tract 3210.01; Marion County; Indiana,2023,1069,815,254,76.23947614593078,23.760523854069223,92,254,36.22047244094488
18097321002,Census Tract 3210.02; Marion County; Indiana,2023,1893,1579,314,83.41257263602746,16.58742736397253,186,314,59.23566878980892
18097321100,Census Tract 3211; Marion County; Indiana,2023,1504,1225,279,81.44946808510639,18.550531914893618,105,279,37.634408602150536
18097321200,Census Tract 3212; Marion County; Indiana,2023,1972,1558,414,79.00608519269777,20.993914807302232,142,414,34.29951690821256
18097321300,Census Tract 3213; Marion County; Indiana,2023,1366,840,526,61.49341142020498,38.50658857979502,126,526,23.954372623574145
18097321400,Census Tract 3214; Marion County; Indiana,2023,2658,1363,1295,51.27915726109857,48.72084273890143,357,1295,27.56756756756757
18097321600,Census Tract 3216; Marion County; Indiana,2023,2378,1438,940,60.47098402018503,39.52901597981497,623,940,66.27659574468085
18097321700,Census Tract 3217; Marion County; Indiana,2023,1924,1371,553,71.25779625779626,28.742203742203742,426,553,77.03435804701627
18097321800,Census Tract 3218; Marion County; Indiana,2023,1409,1131,278,80.26969481902059,19.730305180979418,132,278,47.48201438848921
18097321900,Census Tract 3219; Marion County; Indiana,2023,1211,947,264,78.19983484723369,21.800165152766308,167,264,63.25757575757576
18097322000,Census Tract 3220; Marion County; Indiana,2023,1541,831,710,53.92602206359507,46.07397793640493,298,710,41.971830985915496
18097322100,Census Tract 3221; Marion County; Indiana,2023,930,740,190,79.56989247311827,20.43010752688172,40,190,21.05263157894737
18097322200,Census Tract 3222; Marion County; Indiana,2023,866,622,244,71.82448036951502,28.175519630484988,63,244,25.81967213114754
18097322300,Census Tract 3223; Marion County; Indiana,2023,1027,662,365,64.45959104186953,35.54040895813048,30,365,8.219178082191782
18097322400,Census Tract 3224; Marion County; Indiana,2023,1612,845,767,52.41935483870968,47.58064516129032,403,767,52.54237288135593
18097322500,Census Tract 3225; Marion County; Indiana,2023,770,181,589,23.506493506493506,76.49350649350649,315,589,53.4804753820034
18097322601,Census Tract 3226.01; Marion County; Indiana,2023,958,124,834,12.943632567849686,87.05636743215031,412,834,49.40047961630695
18097322602,Census Tract 3226.02; Marion County; Indiana,2023,800,255,545,31.875,68.125,166,545,30.458715596330276
18097322700,Census Tract 3227; Marion County; Indiana,2023,913,727,186,79.6276013143483,20.3723986856517,45,186,24.193548387096776
18097330103,Census Tract 3301.03; Marion County; Indiana,2023,2078,1240,838,59.672762271414825,40.327237728585175,298,838,35.56085918854415
18097330105,Census Tract 3301.05; Marion County; Indiana,2023,2410,691,1719,28.672199170124482,71.32780082987551,548,1719,31.878999418266435
18097330106,Census Tract 3301.06; Marion County; Indiana,2023,2249,563,1686,25.03334815473544,74.96665184526456,893,1686,52.965599051008304
18097330107,Census Tract 3301.07; Marion County; Indiana,2023,2224,2205,19,99.14568345323741,0.85431654676259,0,19,0
18097330108,Census Tract 3301.08; Marion County; Indiana,2023,1565,1447,118,92.46006389776358,7.539936102236422,0,118,0
18097330109,Census Tract 3301.09; Marion County; Indiana,2023,2009,1873,136,93.23046291687406,6.769537083125933,32,136,23.529411764705884
18097330203,Census Tract 3302.03; Marion County; Indiana,2023,1862,1820,42,97.74436090225564,2.255639097744361,0,42,0
18097330204,Census Tract 3302.04; Marion County; Indiana,2023,2147,2087,60,97.20540288775035,2.7945971122496505,18,60,30
18097330206,Census Tract 3302.06; Marion County; Indiana,2023,1777,1685,92,94.82273494653911,5.177265053460889,28,92,30.434782608695652
18097330208,Census Tract 3302.08; Marion County; Indiana,2023,1231,1005,226,81.64094232331438,18.359057676685623,110,226,48.67256637168141
18097330210,Census Tract 3302.10; Marion County; Indiana,2023,2364,1915,449,81.0067681895093,18.993231810490695,294,449,65.47884187082406
18097330211,Census Tract 3302.11; Marion County; Indiana,2023,1917,910,1007,47.47000521648409,52.52999478351591,494,1007,49.056603773584904
18097330212,Census Tract 3302.12; Marion County; Indiana,2023,1794,1459,335,81.32664437012264,18.67335562987737,115,335,34.32835820895522
18097330213,Census Tract 3302.13; Marion County; Indiana,2023,1450,1081,369,74.55172413793103,25.448275862068964,42,369,11.382113821138212
18097330401,Census Tract 3304.01; Marion County; Indiana,2023,2153,1619,534,75.19739897817,24.802601021830004,237,534,44.38202247191011
18097330500,Census Tract 3305; Marion County; Indiana,2023,2591,2000,591,77.19027402547279,22.80972597452721,323,591,54.653130287648054
18097330600,Census Tract 3306; Marion County; Indiana,2023,2502,1227,1275,49.040767386091126,50.959232613908874,901,1275,70.66666666666667
18097330701,Census Tract 3307.01; Marion County; Indiana,2023,1035,445,590,42.99516908212561,57.00483091787439,364,590,61.69491525423729
18097330702,Census Tract 3307.02; Marion County; Indiana,2023,1494,1213,281,81.19143239625167,18.808567603748326,108,281,38.43416370106762
18097330803,Census Tract 3308.03; Marion County; Indiana,2023,1564,429,1135,27.429667519181585,72.57033248081841,503,1135,44.31718061674009
18097330804,Census Tract 3308.04; Marion County; Indiana,2023,1415,466,949,32.93286219081272,67.06713780918727,388,949,40.88514225500527
18097330805,Census Tract 3308.05; Marion County; Indiana,2023,1166,282,884,24.1852487135506,75.8147512864494,597,884,67.53393665158372
18097330806,Census Tract 3308.06; Marion County; Indiana,2023,1595,587,1008,36.80250783699059,63.19749216300941,541,1008,53.67063492063492
18097330900,Census Tract 3309; Marion County; Indiana,2023,2958,798,2160,26.97768762677485,73.02231237322515,980,2160,45.370370370370374
18097331000,Census Tract 3310; Marion County; Indiana,2023,1636,796,840,48.655256723716384,51.344743276283616,657,840,78.21428571428571
18097340101,Census Tract 3401.01; Marion County; Indiana,2023,1876,1513,363,80.6503198294243,19.34968017057569,113,363,31.12947658402204
18097340102,Census Tract 3401.02; Marion County; Indiana,2023,1988,306,1682,15.392354124748492,84.6076458752515,929,1682,55.23186682520809
18097340108,Census Tract 3401.08; Marion County; Indiana,2023,1338,167,1171,12.481315396113603,87.5186846038864,486,1171,41.50298889837745
18097340111,Census Tract 3401.11; Marion County; Indiana,2023,966,822,144,85.09316770186335,14.906832298136646,117,144,81.25
18097340112,Census Tract 3401.12; Marion County; Indiana,2023,2259,1157,1102,51.21735281097831,48.78264718902169,690,1102,62.613430127041745
18097340113,Census Tract 3401.13; Marion County; Indiana,2023,1578,969,609,61.40684410646388,38.59315589353612,398,609,65.35303776683087
18097340114,Census Tract 3401.14; Marion County; Indiana,2023,1647,1329,318,80.69216757741349,19.30783242258652,93,318,29.245283018867923
18097340115,Census Tract 3401.15; Marion County; Indiana,2023,2979,714,2265,23.967774420946625,76.03222557905337,913,2265,40.30905077262693
18097340201,Census Tract 3402.01; Marion County; Indiana,2023,1292,785,507,60.758513931888544,39.241486068111456,198,507,39.053254437869825
18097340202,Census Tract 3402.02; Marion County; Indiana,2023,1929,822,1107,42.61275272161742,57.38724727838258,363,1107,32.79132791327913
18097340301,Census Tract 3403.01; Marion County; Indiana,2023,1057,454,603,42.95175023651845,57.04824976348155,434,603,71.97346600331674
18097340302,Census Tract 3403.02; Marion County; Indiana,2023,1754,610,1144,34.77765108323831,65.22234891676169,569,1144,49.73776223776224
18097340400,Census Tract 3404; Marion County; Indiana,2023,1376,787,589,57.19476744186046,42.80523255813954,397,589,67.40237691001698
18097340500,Census Tract 3405; Marion County; Indiana,2023,2045,413,1632,20.195599022004888,79.80440097799512,830,1632,50.8578431372549
18097340600,Census Tract 3406; Marion County; Indiana,2023,1690,893,797,52.84023668639053,47.15976331360947,402,797,50.43914680050188
18097340700,Census Tract 3407; Marion County; Indiana,2023,1439,637,802,44.26685198054204,55.73314801945796,422,802,52.61845386533666
18097340800,Census Tract 3408; Marion County; Indiana,2023,716,559,157,78.07262569832402,21.92737430167598,47,157,29.936305732484076
18097340901,Census Tract 3409.01; Marion County; Indiana,2023,1210,1087,123,89.83471074380165,10.165289256198347,34,123,27.642276422764226
18097340903,Census Tract 3409.03; Marion County; Indiana,2023,1103,147,956,13.327289211242068,86.67271078875794,445,956,46.54811715481171
18097340904,Census Tract 3409.04; Marion County; Indiana,2023,2336,726,1610,31.078767123287673,68.92123287671232,663,1610,41.18012422360248
18097341000,Census Tract 3410; Marion County; Indiana,2023,730,612,118,83.83561643835617,16.164383561643834,41,118,34.74576271186441
18097341100,Census Tract 3411; Marion County; Indiana,2023,813,356,457,43.788437884378844,56.211562115621156,197,457,43.10722100656455
18097341200,Census Tract 3412; Marion County; Indiana,2023,840,433,407,51.54761904761905,48.45238095238095,276,407,67.81326781326781
18097341600,Census Tract 3416; Marion County; Indiana,2023,889,493,396,55.455568053993254,44.544431946006746,275,396,69.44444444444444
18097341701,Census Tract 3417.01; Marion County; Indiana,2023,909,543,366,59.73597359735974,40.26402640264026,163,366,44.53551912568306
18097341702,Census Tract 3417.02; Marion County; Indiana,2023,822,472,350,57.420924574209245,42.579075425790755,136,350,38.857142857142854
18097341902,Census Tract 3419.02; Marion County; Indiana,2023,1655,1247,408,75.34743202416918,24.652567975830816,205,408,50.245098039215684
18097341903,Census Tract 3419.03; Marion County; Indiana,2023,1934,338,1596,17.47673216132368,82.52326783867632,625,1596,39.16040100250627
18097341904,Census Tract 3419.04; Marion County; Indiana,2023,943,393,550,41.675503711558854,58.324496288441146,262,550,47.63636363636363
18097342000,Census Tract 3420; Marion County; Indiana,2023,2054,1582,472,77.02044790652386,22.979552093476144,130,472,27.54237288135593
18097342101,Census Tract 3421.01; Marion County; Indiana,2023,2195,1321,874,60.182232346241456,39.817767653758544,319,874,36.49885583524028
18097342200,Census Tract 3422; Marion County; Indiana,2023,1830,1005,825,54.91803278688525,45.08196721311475,417,825,50.54545454545455
18097342300,Census Tract 3423; Marion County; Indiana,2023,2178,1227,951,56.33608815426997,43.66391184573003,451,951,47.423764458464774
18097342400,Census Tract 3424; Marion County; Indiana,2023,524,355,169,67.74809160305344,32.25190839694657,72,169,42.603550295857985
18097342500,Census Tract 3425; Marion County; Indiana,2023,1718,970,748,56.461001164144356,43.538998835855644,386,748,51.60427807486631
18097342600,Census Tract 3426; Marion County; Indiana,2023,1122,565,557,50.35650623885918,49.64349376114082,181,557,32.49551166965889
18097350100,Census Tract 3501; Marion County; Indiana,2023,628,477,151,75.95541401273886,24.044585987261147,49,151,32.450331125827816
18097350300,Census Tract 3503; Marion County; Indiana,2023,1599,283,1316,17.698561601000627,82.30143839899938,754,1316,57.29483282674772
18097350400,Census Tract 3504; Marion County; Indiana,2023,1068,506,562,47.37827715355805,52.62172284644195,239,562,42.52669039145908
18097350500,Census Tract 3505; Marion County; Indiana,2023,973,660,313,67.83144912641316,32.168550873586845,171,313,54.63258785942492
18097350600,Census Tract 3506; Marion County; Indiana,2023,2339,1391,948,59.46985891406584,40.53014108593416,770,948,81.22362869198312
18097350700,Census Tract 3507; Marion County; Indiana,2023,789,309,480,39.163498098859314,60.836501901140686,300,480,62.5
18097350800,Census Tract 3508; Marion County; Indiana,2023,857,259,598,30.221703617269544,69.77829638273046,354,598,59.197324414715716
18097350900,Census Tract 3509; Marion County; Indiana,2023,751,471,280,62.71637816245007,37.28362183754993,182,280,65
18097351000,Census Tract 3510; Marion County; Indiana,2023,945,578,367,61.164021164021165,38.835978835978835,170,367,46.321525885558586
18097351200,Census Tract 3512; Marion County; Indiana,2023,1174,604,570,51.44804088586031,48.55195911413969,274,570,48.07017543859649
18097351500,Census Tract 3515; Marion County; Indiana,2023,980,333,647,33.97959183673469,66.0204081632653,332,647,51.31375579598145
18097351600,Census Tract 3516; Marion County; Indiana,2023,1250,754,496,60.32,39.68,145,496,29.233870967741936
18097351700,Census Tract 3517; Marion County; Indiana,2023,1232,734,498,59.577922077922075,40.422077922077925,175,498,35.140562248995984
18097351900,Census Tract 3519; Marion County; Indiana,2023,1085,632,453,58.24884792626728,41.75115207373272,284,453,62.69315673289183
18097352100,Census Tract 3521; Marion County; Indiana,2023,765,355,410,46.40522875816993,53.59477124183007,180,410,43.90243902439025
18097352300,Census Tract 3523; Marion County; Indiana,2023,608,301,307,49.50657894736842,50.49342105263158,151,307,49.185667752442995
18097352400,Census Tract 3524; Marion County; Indiana,2023,1355,450,905,33.210332103321036,66.78966789667896,480,905,53.03867403314917
18097352500,Census Tract 3525; Marion County; Indiana,2023,1718,903,815,52.56111757857975,47.43888242142025,431,815,52.88343558282209
18097352600,Census Tract 3526; Marion County; Indiana,2023,1534,692,842,45.11082138200782,54.88917861799218,405,842,48.09976247030879
18097352700,Census Tract 3527; Marion County; Indiana,2023,935,645,290,68.98395721925134,31.016042780748663,164,290,56.55172413793103
18097352800,Census Tract 3528; Marion County; Indiana,2023,714,133,581,18.627450980392158,81.37254901960785,270,581,46.47160068846816
18097353300,Census Tract 3533; Marion County; Indiana,2023,1492,329,1163,22.050938337801608,77.94906166219839,586,1163,50.386930352536545
18097353500,Census Tract 3535; Marion County; Indiana,2023,1271,133,1138,10.464201416207711,89.53579858379229,723,1138,63.53251318101933
18097353600,Census Tract 3536; Marion County; Indiana,2023,1196,383,813,32.02341137123746,67.97658862876254,379,813,46.61746617466174
18097354201,Census Tract 3542.01; Marion County; Indiana,2023,2615,778,1837,29.751434034416825,70.24856596558317,772,1837,42.02504082743604
18097354202,Census Tract 3542.02; Marion County; Indiana,2023,2423,622,1801,25.670656211308295,74.3293437886917,575,1801,31.92670738478623
18097354400,Census Tract 3544; Marion County; Indiana,2023,699,515,184,73.67668097281832,26.32331902718169,75,184,40.76086956521739
18097354500,Census Tract 3545; Marion County; Indiana,2023,859,388,471,45.16880093131548,54.83119906868452,153,471,32.48407643312102
18097354700,Census Tract 3547; Marion County; Indiana,2023,685,269,416,39.27007299270073,60.72992700729927,132,416,31.73076923076923
18097354800,Census Tract 3548; Marion County; Indiana,2023,711,506,205,71.16736990154712,28.832630098452885,111,205,54.146341463414636
18097354900,Census Tract 3549; Marion County; Indiana,2023,1351,417,934,30.866025166543302,69.1339748334567,447,934,47.85867237687366
18097355000,Census Tract 3550; Marion County; Indiana,2023,801,472,329,58.92634207240949,41.07365792759051,101,329,30.699088145896656
18097355100,Census Tract 3551; Marion County; Indiana,2023,974,241,733,24.743326488706366,75.25667351129364,526,733,71.75989085948159
18097355300,Census Tract 3553; Marion County; Indiana,2023,1152,476,676,41.31944444444444,58.68055555555556,369,676,54.585798816568044
18097355400,Census Tract 3554; Marion County; Indiana,2023,1290,557,733,43.17829457364341,56.82170542635659,308,733,42.01909959072306
18097355500,Census Tract 3555; Marion County; Indiana,2023,1498,1030,468,68.75834445927904,31.241655540720963,163,468,34.82905982905983
18097355600,Census Tract 3556; Marion County; Indiana,2023,914,374,540,40.91903719912472,59.08096280087528,295,540,54.629629629629626
18097355700,Census Tract 3557; Marion County; Indiana,2023,997,486,511,48.74623871614845,51.25376128385155,297,511,58.12133072407045
18097355900,Census Tract 3559; Marion County; Indiana,2023,1087,633,454,58.233670653173874,41.766329346826126,232,454,51.10132158590309
18097356200,Census Tract 3562; Marion County; Indiana,2023,1296,299,997,23.070987654320987,76.92901234567901,241,997,24.172517552657975
18097356400,Census Tract 3564; Marion County; Indiana,2023,1775,471,1304,26.535211267605632,73.46478873239437,613,1304,47.00920245398773
18097356900,Census Tract 3569; Marion County; Indiana,2023,912,621,291,68.09210526315789,31.907894736842106,118,291,40.549828178694156
18097357000,Census Tract 3570; Marion County; Indiana,2023,942,631,311,66.98513800424628,33.01486199575371,169,311,54.340836012861736
18097357100,Census Tract 3571; Marion County; Indiana,2023,994,496,498,49.899396378269614,50.100603621730386,258,498,51.80722891566265
18097357200,Census Tract 3572; Marion County; Indiana,2023,1029,656,373,63.751214771622934,36.248785228377066,121,373,32.43967828418231
18097357300,Census Tract 3573; Marion County; Indiana,2023,881,384,497,43.58683314415437,56.41316685584563,230,497,46.27766599597585
18097357400,Census Tract 3574; Marion County; Indiana,2023,1602,912,690,56.92883895131086,43.07116104868914,410,690,59.42028985507246
18097357500,Census Tract 3575; Marion County; Indiana,2023,1278,953,325,74.56964006259781,25.43035993740219,253,325,77.84615384615384
18097357601,Census Tract 3576.01; Marion County; Indiana,2023,1785,872,913,48.851540616246496,51.148459383753504,549,913,60.13143483023001
18097357602,Census Tract 3576.02; Marion County; Indiana,2023,477,219,258,45.911949685534594,54.088050314465406,123,258,47.674418604651166
18097357800,Census Tract 3578; Marion County; Indiana,2023,678,311,367,45.87020648967552,54.12979351032448,230,367,62.67029972752044
18097357900,Census Tract 3579; Marion County; Indiana,2023,1489,914,575,61.383478844862324,38.616521155137676,345,575,60
18097358000,Census Tract 3580; Marion County; Indiana,2023,506,290,216,57.312252964426875,42.687747035573125,129,216,59.72222222222222
18097358100,Census Tract 3581; Marion County; Indiana,2023,954,557,397,58.38574423480084,41.61425576519916,233,397,58.69017632241814
18097360101,Census Tract 3601.01; Marion County; Indiana,2023,1139,382,757,33.53819139596137,66.46180860403864,430,757,56.80317040951123
18097360102,Census Tract 3601.02; Marion County; Indiana,2023,855,480,375,56.14035087719298,43.85964912280702,237,375,63.2
18097360201,Census Tract 3602.01; Marion County; Indiana,2023,1926,534,1392,27.725856697819314,72.27414330218069,651,1392,46.76724137931034
18097360202,Census Tract 3602.02; Marion County; Indiana,2023,1076,856,220,79.5539033457249,20.44609665427509,91,220,41.36363636363637
18097360301,Census Tract 3603.01; Marion County; Indiana,2023,1368,669,699,48.90350877192982,51.09649122807018,356,699,50.929899856938484
18097360302,Census Tract 3603.02; Marion County; Indiana,2023,1087,342,745,31.462741490340388,68.53725850965961,540,745,72.48322147651007
18097360401,Census Tract 3604.01; Marion County; Indiana,2023,2709,448,2261,16.537467700258397,83.4625322997416,928,2261,41.043785935426804
18097360402,Census Tract 3604.02; Marion County; Indiana,2023,1073,512,561,47.71668219944082,52.28331780055918,496,561,88.41354723707664
18097360405,Census Tract 3604.05; Marion County; Indiana,2023,2565,1730,835,67.44639376218323,32.553606237816766,373,835,44.67065868263473
18097360406,Census Tract 3604.06; Marion County; Indiana,2023,1700,636,1064,37.411764705882355,62.588235294117645,601,1064,56.484962406015036
18097360407,Census Tract 3604.07; Marion County; Indiana,2023,1268,593,675,46.76656151419559,53.23343848580441,340,675,50.370370370370374
18097360501,Census Tract 3605.01; Marion County; Indiana,2023,2364,1725,639,72.96954314720813,27.03045685279188,300,639,46.948356807511736
18097360502,Census Tract 3605.02; Marion County; Indiana,2023,2108,1548,560,73.43453510436433,26.565464895635674,506,560,90.35714285714286
18097360601,Census Tract 3606.01; Marion County; Indiana,2023,1815,1427,388,78.62258953168045,21.37741046831956,229,388,59.02061855670103
18097360602,Census Tract 3606.02; Marion County; Indiana,2023,2435,1212,1223,49.7741273100616,50.2258726899384,777,1223,63.532297628781684
18097360700,Census Tract 3607; Marion County; Indiana,2023,796,654,142,82.1608040201005,17.839195979899497,85,142,59.859154929577464
18097360800,Census Tract 3608; Marion County; Indiana,2023,1144,377,767,32.95454545454545,67.04545454545455,455,767,59.32203389830509
18097360900,Census Tract 3609; Marion County; Indiana,2023,2349,1240,1109,52.78842060451256,47.21157939548744,715,1109,64.47249774571686
18097361000,Census Tract 3610; Marion County; Indiana,2023,982,869,113,88.4928716904277,11.507128309572302,64,113,56.63716814159292
18097361100,Census Tract 3611; Marion County; Indiana,2023,1438,916,522,63.69958275382476,36.30041724617524,239,522,45.78544061302682
18097361200,Census Tract 3612; Marion County; Indiana,2023,1394,822,572,58.96700143472023,41.03299856527977,148,572,25.874125874125873
18097361300,Census Tract 3613; Marion County; Indiana,2023,986,775,211,78.60040567951319,21.399594320486816,58,211,27.488151658767773
18097361401,Census Tract 3614.01; Marion County; Indiana,2023,1889,1225,664,64.8491265219693,35.150873478030704,481,664,72.43975903614458
18097361402,Census Tract 3614.02; Marion County; Indiana,2023,2081,1292,789,62.08553580009611,37.91446419990389,287,789,36.37515842839037
18097361601,Census Tract 3616.01; Marion County; Indiana,2023,1959,1805,154,92.13884635017867,7.861153649821337,128,154,83.11688311688312
18097361602,Census Tract 3616.02; Marion County; Indiana,2023,1267,1215,52,95.89581689029202,4.1041831097079715,0,52,0
18097370201,Census Tract 3702.01; Marion County; Indiana,2023,1314,609,705,46.34703196347032,53.65296803652968,435,705,61.702127659574465
18097370203,Census Tract 3702.03; Marion County; Indiana,2023,1545,608,937,39.35275080906149,60.64724919093851,609,937,64.99466382070437
18097370204,Census Tract 3702.04; Marion County; Indiana,2023,1463,982,481,67.12235133287764,32.87764866712235,271,481,56.34095634095634
18097370303,Census Tract 3703.03; Marion County; Indiana,2023,2462,1749,713,71.03980503655565,28.960194963444355,317,713,44.460028050490884
18097370304,Census Tract 3703.04; Marion County; Indiana,2023,1359,1187,172,87.34363502575422,12.656364974245768,110,172,63.95348837209303
18097370305,Census Tract 3703.05; Marion County; Indiana,2023,1729,589,1140,34.065934065934066,65.93406593406593,944,1140,82.80701754385964
18097370306,Census Tract 3703.06; Marion County; Indiana,2023,1930,1742,188,90.25906735751295,9.740932642487047,57,188,30.319148936170212
18097380101,Census Tract 3801.01; Marion County; Indiana,2023,2983,2730,253,91.51860543077439,8.481394569225612,77,253,30.434782608695652
18097380102,Census Tract 3801.02; Marion County; Indiana,2023,1351,898,453,66.46928201332346,33.530717986676535,53,453,11.699779249448124
18097380103,Census Tract 3801.03; Marion County; Indiana,2023,3141,1941,1200,61.7956064947469,38.2043935052531,586,1200,48.833333333333336
18097380200,Census Tract 3802; Marion County; Indiana,2023,1584,747,837,47.15909090909091,52.84090909090909,566,837,67.62246117084827
18097380301,Census Tract 3803.01; Marion County; Indiana,2023,823,593,230,72.05346294046173,27.946537059538276,209,230,90.8695652173913
18097380302,Census Tract 3803.02; Marion County; Indiana,2023,998,410,588,41.08216432865731,58.91783567134269,303,588,51.53061224489796
18097380402,Census Tract 3804.02; Marion County; Indiana,2023,2073,650,1423,31.35552339604438,68.64447660395562,746,1423,52.42445537596627
18097380403,Census Tract 3804.03; Marion County; Indiana,2023,1522,1177,345,77.33245729303547,22.66754270696452,132,345,38.26086956521739
18097380404,Census Tract 3804.04; Marion County; Indiana,2023,1647,1277,370,77.534911961141475,22.465088038858532,237,370,64.05405405405405
18097380501,Census Tract 3805.01; Marion County; Indiana,2023,901,515,386,57.158712541620424,42.841287458379576,264,386,68.39378238341969
18097380502,Census Tract 3805.02; Marion County; Indiana,2023,1589,522,1067,32.8508495909377,67.1491504090623,623,1067,58.38800374882849
18097380600,Census Tract 3806; Marion County; Indiana,2023,2175,1024,1151,47.08045977011494,52.91954022988506,574,1151,49.869678540399654
18097380700,Census Tract 3807; Marion County; Indiana,2023,2719,1481,1238,54.46855461566752,45.53144538433248,845,1238,68.25525040387723
18097380800,Census Tract 3808; Marion County; Indiana,2023,1259,862,397,68.46703733121525,31.53296266878475,172,397,43.32493702770781
18097380901,Census Tract 3809.01; Marion County; Indiana,2023,1974,1854,120,93.9209726443769,6.079027355623101,0,120,0
18097380902,Census Tract 3809.02; Marion County; Indiana,2023,2649,1868,781,70.51717629294073,29.482823707059268,231,781,29.577464788732396
18097381002,Census Tract 3810.02; Marion County; Indiana,2023,1463,1319,144,90.15721120984279,9.842788790157211,45,144,31.25
18097381003,Census Tract 3810.03; Marion County; Indiana,2023,1569,630,939,40.152963671128106,59.847036328871894,513,939,54.63258785942492
18097381004,Census Tract 3810.04; Marion County; Indiana,2023,1553,421,1132,27.108821635544107,72.8911783644559,659,1132,58.215547703180214
18097381101,Census Tract 3811.01; Marion County; Indiana,2023,2507,1588,919,63.34264060630235,36.65735939369765,496,919,53.97170837867247
18097381102,Census Tract 3811.02; Marion County; Indiana,2023,2793,2307,486,82.59935553168636,17.40064446831364,189,486,38.888888888888886
18097381203,Census Tract 3812.03; Marion County; Indiana,2023,1129,321,808,28.432240921169175,71.56775907883082,493,808,61.01485148514851
18097381204,Census Tract 3812.04; Marion County; Indiana,2023,1509,119,1390,7.8860172299536115,92.11398277004639,929,1390,66.83453237410072
18097381205,Census Tract 3812.05; Marion County; Indiana,2023,2605,1043,1562,40.0383877159309,59.9616122840691,643,1562,41.1651728553137
18097381206,Census Tract 3812.06; Marion County; Indiana,2023,1788,892,896,49.88814317673378,50.11185682326622,287,896,32.03125
18097381207,Census Tract 3812.07; Marion County; Indiana,2023,1530,1492,38,97.51633986928104,2.4836601307189543,0,38,0
18097390102,Census Tract 3901.02; Marion County; Indiana,2023,2688,967,1721,35.97470238095238,64.02529761904762,1027,1721,59.67460778617083
18097390103,Census Tract 3901.03; Marion County; Indiana,2023,1391,1187,204,85.33429187634795,14.665708123652049,84,204,41.1764705882353
18097390104,Census Tract 3901.04; Marion County; Indiana,2023,2612,2133,479,81.66156202143951,18.33843797856049,135,479,28.183716075156575
18097390200,Census Tract 3902; Marion County; Indiana,2023,2224,1932,292,86.87050359712231,13.129496402877697,90,292,30.82191780821918
18097390300,Census Tract 3903; Marion County; Indiana,2023,2408,2184,224,90.69767441860465,9.30232558139535,63,224,28.125
18097390405,Census Tract 3904.05; Marion County; Indiana,2023,1973,662,1311,33.55296502787633,66.44703497212367,310,1311,23.64607170099161
18097390406,Census Tract 3904.06; Marion County; Indiana,2023,2083,1935,148,92.8948631781085,7.105136821891502,64,148,43.24324324324324
18097390407,Census Tract 3904.07; Marion County; Indiana,2023,2108,2085,23,98.9089184060721,1.0910815939278937,0,23,0
18097390408,Census Tract 3904.08; Marion County; Indiana,2023,1831,1728,103,94.37465865647188,5.6253413435281265,23,103,22.33009708737864
18097390409,Census Tract 3904.09; Marion County; Indiana,2023,2845,2411,434,84.74516695957821,15.254833040421792,220,434,50.69124423963134
18097390410,Census Tract 3904.10; Marion County; Indiana,2023,794,565,229,71.15869017632242,28.84130982367758,53,229,23.14410480349345
18097390411,Census Tract 3904.11; Marion County; Indiana,2023,1484,1057,427,71.22641509433963,28.77358490566038,247,427,57.84543325526932
18097390500,Census Tract 3905; Marion County; Indiana,2023,1157,697,460,60.24200518582541,39.75799481417459,172,460,37.391304347826086
18097390601,Census Tract 3906.01; Marion County; Indiana,2023,922,181,741,19.63123644251627,80.36876355748373,332,741,44.80431848852901
18097390602,Census Tract 3906.02; Marion County; Indiana,2023,2000,540,1460,27,73,665,1460,45.54794520547945
18097390700,Census Tract 3907; Marion County; Indiana,2023,1384,987,397,71.31502890173411,28.684971098265898,188,397,47.3551637279597
18097390801,Census Tract 3908.01; Marion County; Indiana,2023,0,0,0,NA,NA,0,0,NA
18097390802,Census Tract 3908.02; Marion County; Indiana,2023,1470,781,689,53.12925170068027,46.87074829931973,396,689,57.47460087082729
18097390900,Census Tract 3909; Marion County; Indiana,2023,1597,727,870,45.52285535378835,54.47714464621165,395,870,45.40229885057471
18097391001,Census Tract 3910.01; Marion County; Indiana,2023,428,50,378,11.682242990654206,88.3177570093458,150,378,39.682539682539684
18097391002,Census Tract 3910.02; Marion County; Indiana,2023,3605,385,3220,10.679611650485437,89.32038834951456,1131,3220,35.12422360248447
